State,Year,Period,labor force,employment,unemployment,unemployment rate
Alabama,1976,Annual,1501284,1399080,102204,6.8
Alabama,1977,Annual,1568504,1453781,114723,7.3
Alabama,1978,Annual,1621710,1518309,103401,6.4
Alabama,1979,Annual,1656358,1537596,118762,7.2
Alabama,1980,Annual,1669289,1521183,148106,8.9
Alabama,1981,Annual,1677652,1500534,177118,10.6
Alabama,1982,Annual,1716324,1474143,242181,14.1
Alabama,1983,Annual,1756953,1514551,242402,13.8
Alabama,1984,Annual,1788133,1591093,197040,11.0
Alabama,1985,Annual,1802728,1637751,164977,9.2
Alabama,1986,Annual,1861327,1680722,180605,9.7
Alabama,1987,Annual,1869005,1718107,150898,8.1
Alabama,1988,Annual,1877663,1742376,135287,7.2
Alabama,1989,Annual,1896227,1762813,133414,7.0
Alabama,1990,Annual,1907367,1778143,129224,6.8
Alabama,1991,Annual,1920555,1779490,141065,7.3
Alabama,1992,Annual,1965516,1816526,148990,7.6
Alabama,1993,Annual,2003905,1856754,147151,7.3
Alabama,1994,Annual,2026692,1900856,125836,6.2
Alabama,1995,Annual,2067444,1943878,123566,6.0
Alabama,1996,Annual,2086463,1977334,109129,5.2
Alabama,1997,Annual,2133573,2027064,106509,5.0
Alabama,1998,Annual,2136177,2042291,93886,4.4
Alabama,1999,Annual,2140296,2038889,101407,4.7
Alabama,2000,Annual,2133223,2035594,97629,4.6
Alabama,2001,Annual,2115401,2006884,108517,5.1
Alabama,2002,Annual,2106161,1981919,124242,5.9
Alabama,2003,Annual,2120225,1992732,127493,6.0
Alabama,2004,Annual,2136458,2014889,121569,5.7
Alabama,2005,Annual,2146025,2049791,96234,4.5
Alabama,2006,Annual,2167809,2080233,87576,4.0
Alabama,2007,Annual,2175612,2089127,86485,4.0
Alabama,2008,Annual,2176489,2053477,123012,5.7
Alabama,2009,Annual,2162999,1924747,238252,11.0
Alabama,2010,Annual,2196042,1964559,231483,10.5
Alabama,2011,Annual,2202670,1990413,212257,9.6
Alabama,2012,Annual,2176337,2003290,173047,8.0
Alabama,2013,Annual,2174000,2017043,156957,7.2
Alabama,2014,Annual,2161618,2015087,146531,6.8
Alabama,2015,Annual,2157376,2025949,131427,6.1
Alabama,2016,Annual,2173175,2045624,127551,5.9
Alabama,2017,Annual,2168444,2073106,95338,4.4
Alaska,1976,Annual,163570,151190,12380,7.6
Alaska,1977,Annual,173013,155948,17065,9.9
Alaska,1978,Annual,182111,162730,19381,10.6
Alaska,1979,Annual,183807,166730,17077,9.3
Alaska,1980,Annual,187405,169397,18008,9.6
Alaska,1981,Annual,196157,177803,18354,9.4
Alaska,1982,Annual,212806,191699,21107,9.9
Alaska,1983,Annual,231721,208713,23008,9.9
Alaska,1984,Annual,245452,221308,24144,9.8
Alaska,1985,Annual,252127,227693,24434,9.7
Alaska,1986,Annual,255131,227228,27903,10.9
Alaska,1987,Annual,248599,223042,25557,10.3
Alaska,1988,Annual,248861,226968,21893,8.8
Alaska,1989,Annual,255617,237686,17931,7.0
Alaska,1990,Annual,268422,249038,19384,7.2
Alaska,1991,Annual,276276,252921,23355,8.5
Alaska,1992,Annual,287216,261624,25592,8.9
Alaska,1993,Annual,295432,272709,22723,7.7
Alaska,1994,Annual,302371,279471,22900,7.6
Alaska,1995,Annual,304160,281889,22271,7.3
Alaska,1996,Annual,309772,286252,23520,7.6
Alaska,1997,Annual,313217,290845,22372,7.1
Alaska,1998,Annual,315870,295823,20047,6.3
Alaska,1999,Annual,317943,297354,20589,6.5
Alaska,2000,Annual,319511,299146,20365,6.4
Alaska,2001,Annual,321393,300731,20662,6.4
Alaska,2002,Annual,326401,302580,23821,7.3
Alaska,2003,Annual,331669,305723,25946,7.8
Alaska,2004,Annual,336743,311643,25100,7.5
Alaska,2005,Annual,344559,320811,23748,6.9
Alaska,2006,Annual,349691,326542,23149,6.6
Alaska,2007,Annual,350785,328579,22206,6.3
Alaska,2008,Annual,356109,332285,23824,6.7
Alaska,2009,Annual,359647,331792,27855,7.7
Alaska,2010,Annual,361913,333416,28497,7.9
Alaska,2011,Annual,365913,338161,27752,7.6
Alaska,2012,Annual,365519,339474,26045,7.1
Alaska,2013,Annual,365292,339801,25491,7.0
Alaska,2014,Annual,365704,340585,25119,6.9
Alaska,2015,Annual,363872,340132,23740,6.5
Alaska,2016,Annual,363047,337947,25100,6.9
Alaska,2017,Annual,362783,336806,25977,7.2
Arizona,1976,Annual,987060,890988,96072,9.7
Arizona,1977,Annual,1042116,956606,85510,8.2
Arizona,1978,Annual,1082446,1017179,65267,6
Arizona,1979,Annual,1152471,1093987,58484,5.1
Arizona,1980,Annual,1228001,1146371,81630,6.6
Arizona,1981,Annual,1271678,1192377,79301,6.2
Arizona,1982,Annual,1341767,1206118,135649,10.1
Arizona,1983,Annual,1386057,1264176,121881,8.8
Arizona,1984,Annual,1431770,1357616,74154,5.2
Arizona,1985,Annual,1487075,1392656,94419,6.3
Arizona,1986,Annual,1562728,1454740,107988,6.9
Arizona,1987,Annual,1618230,1513853,104377,6.5
Arizona,1988,Annual,1666073,1559871,106202,6.4
Arizona,1989,Annual,1718674,1627178,91496,5.3
Arizona,1990,Annual,1786186,1691876,94310,5.3
Arizona,1991,Annual,1805012,1697675,107337,5.9
Arizona,1992,Annual,1873606,1732327,141279,7.5
Arizona,1993,Annual,1949027,1824253,124774,6.4
Arizona,1994,Annual,2104125,1974779,129346,6.1
Arizona,1995,Annual,2229131,2109900,119231,5.3
Arizona,1996,Annual,2285205,2157966,127239,5.6
Arizona,1997,Annual,2308569,2202911,105658,4.6
Arizona,1998,Annual,2387027,2284323,102704,4.3
Arizona,1999,Annual,2473013,2363084,109929,4.4
Arizona,2000,Annual,2509883,2410581,99302,4
Arizona,2001,Annual,2585284,2461498,123786,4.8
Arizona,2002,Annual,2679421,2516006,163415,6.1
Arizona,2003,Annual,2736000,2578854,157146,5.7
Arizona,2004,Annual,2796269,2655428,140841,5
Arizona,2005,Annual,2883226,2748372,134854,4.7
Arizona,2006,Annual,2990441,2864385,126056,4.2
Arizona,2007,Annual,3034016,2917117,116899,3.9
Arizona,2008,Annual,3104863,2913903,190960,6.2
Arizona,2009,Annual,3128110,2817577,310533,9.9
Arizona,2010,Annual,3089705,2769454,320251,10.4
Arizona,2011,Annual,3037017,2748470,288547,9.5
Arizona,2012,Annual,3028878,2776349,252529,8.3
Arizona,2013,Annual,3029425,2794697,234728,7.7
Arizona,2014,Annual,3087942,2878611,209331,6.8
Arizona,2015,Annual,3153040,2962245,190795,6.1
Arizona,2016,Annual,3225703,3052788,172915,5.4
Arizona,2017,Annual,3312720,3151405,161315,4.9
Arkansas,1976,Annual,891608,829394,62214,7.0
Arkansas,1977,Annual,930260,869982,60278,6.5
Arkansas,1978,Annual,952308,893511,58797,6.2
Arkansas,1979,Annual,984461,923371,61090,6.2
Arkansas,1980,Annual,998280,922894,75386,7.6
Arkansas,1981,Annual,1023163,933766,89397,8.7
Arkansas,1982,Annual,1024106,922554,101552,9.9
Arkansas,1983,Annual,1031664,930038,101626,9.9
Arkansas,1984,Annual,1042889,952014,90875,8.7
Arkansas,1985,Annual,1047947,956947,91000,8.7
Arkansas,1986,Annual,1067484,976138,91346,8.6
Arkansas,1987,Annual,1092247,1003871,88376,8.1
Arkansas,1988,Annual,1111749,1027345,84404,7.6
Arkansas,1989,Annual,1128467,1049579,78888,7.0
Arkansas,1990,Annual,1131830,1053833,77997,6.9
Arkansas,1991,Annual,1129518,1045529,83989,7.4
Arkansas,1992,Annual,1154527,1072508,82019,7.1
Arkansas,1993,Annual,1177924,1105538,72386,6.1
Arkansas,1994,Annual,1218426,1153107,65319,5.4
Arkansas,1995,Annual,1238738,1178835,59903,4.8
Arkansas,1996,Annual,1248668,1183048,65620,5.3
Arkansas,1997,Annual,1242594,1177521,65073,5.2
Arkansas,1998,Annual,1241352,1177122,64230,5.2
Arkansas,1999,Annual,1255032,1197320,57712,4.6
Arkansas,2000,Annual,1258301,1204695,53606,4.3
Arkansas,2001,Annual,1253456,1191273,62183,5.0
Arkansas,2002,Annual,1270997,1201422,69575,5.5
Arkansas,2003,Annual,1271696,1196299,75397,5.9
Arkansas,2004,Annual,1300318,1226123,74195,5.7
Arkansas,2005,Annual,1345913,1275448,70465,5.2
Arkansas,2006,Annual,1365410,1294906,70504,5.2
Arkansas,2007,Annual,1369284,1296572,72712,5.3
Arkansas,2008,Annual,1375257,1300017,75240,5.5
Arkansas,2009,Annual,1358911,1252399,106512,7.8
Arkansas,2010,Annual,1353338,1242496,110842,8.2
Arkansas,2011,Annual,1362682,1249514,113168,8.3
Arkansas,2012,Annual,1342753,1241127,101626,7.6
Arkansas,2013,Annual,1322576,1226859,95717,7.2
Arkansas,2014,Annual,1316595,1237316,79279,6.0
Arkansas,2015,Annual,1332255,1265166,67089,5.0
Arkansas,2016,Annual,1342561,1289549,53012,3.9
Arkansas,2017,Annual,1354265,1304434,49831,3.7
California,1976,Annual,9899372,8994291,905081,9.1
California,1977,Annual,10382340,9518343,863997,8.3
California,1978,Annual,10905557,10125077,780480,7.2
California,1979,Annual,11279488,10574856,704632,6.2
California,1980,Annual,11579052,10787673,791379,6.8
California,1981,Annual,11829789,10953612,876177,7.4
California,1982,Annual,12152372,10942811,1209561,10.0
California,1983,Annual,12293797,11090005,1203792,9.8
California,1984,Annual,12637075,11656587,980488,7.8
California,1985,Annual,12982818,12051618,931200,7.2
California,1986,Annual,13335690,12438577,897113,6.7
California,1987,Annual,13743990,12945765,798225,5.8
California,1988,Annual,14141442,13392506,748936,5.3
California,1989,Annual,14552934,13806871,746063,5.1
California,1990,Annual,15138423,14264158,874265,5.8
California,1991,Annual,15126481,13960003,1166478,7.7
California,1992,Annual,15304998,13880944,1424054,9.3
California,1993,Annual,15261199,13817032,1444167,9.5
California,1994,Annual,15256527,13944739,1311788,8.6
California,1995,Annual,15246014,14048225,1197789,7.9
California,1996,Annual,15422616,14300443,1122173,7.3
California,1997,Annual,15790063,14784636,1005427,6.4
California,1998,Annual,16144564,15184470,960094,5.9
California,1999,Annual,16416600,15555278,861322,5.2
California,2000,Annual,16867808,16033179,834629,4.9
California,2001,Annual,17128430,16197671,930759,5.4
California,2002,Annual,17257097,16108685,1148412,6.7
California,2003,Annual,17277618,16102840,1174778,6.8
California,2004,Annual,17383631,16303996,1079635,6.2
California,2005,Annual,17530064,16582651,947413,5.4
California,2006,Annual,17654109,16789422,864687,4.9
California,2007,Annual,17893080,16931590,961490,5.4
California,2008,Annual,18178123,16854482,1323641,7.3
California,2009,Annual,18215140,16182572,2032568,11.2
California,2010,Annual,18336271,16091945,2244326,12.2
California,2011,Annual,18415100,16258133,2156967,11.7
California,2012,Annual,18523793,16602672,1921121,10.4
California,2013,Annual,18624992,16958403,1666589,8.9
California,2014,Annual,18758399,17351318,1407081,7.5
California,2015,Annual,18896477,17724799,1171678,6.2
California,2016,Annual,19093658,18048827,1044831,5.5
California,2017,Annual,19311958,18393077,918881,4.8
Colorado,1976,Annual,1241819,1169467,72352,5.8
Colorado,1977,Annual,1292960,1210829,82131,6.4
Colorado,1978,Annual,1347646,1272961,74685,5.5
Colorado,1979,Annual,1429392,1361535,67857,4.7
Colorado,1980,Annual,1491648,1405381,86267,5.8
Colorado,1981,Annual,1539314,1450918,88396,5.7
Colorado,1982,Annual,1595941,1478789,117152,7.3
Colorado,1983,Annual,1666793,1548743,118050,7.1
Colorado,1984,Annual,1715898,1622610,93288,5.4
Colorado,1985,Annual,1714199,1610284,103915,6.1
Colorado,1986,Annual,1705842,1577648,128194,7.5
Colorado,1987,Annual,1701342,1573086,128256,7.5
Colorado,1988,Annual,1697028,1586629,110399,6.5
Colorado,1989,Annual,1702489,1606176,96313,5.7
Colorado,1990,Annual,1763683,1671823,91860,5.2
Colorado,1991,Annual,1794287,1700069,94218,5.3
Colorado,1992,Annual,1845245,1734715,110530,6.0
Colorado,1993,Annual,1931142,1828679,102463,5.3
Colorado,1994,Annual,2039524,1952999,86525,4.2
Colorado,1995,Annual,2124988,2039647,85341,4.0
Colorado,1996,Annual,2154732,2063318,91414,4.2
Colorado,1997,Annual,2217553,2140797,76756,3.5
Colorado,1998,Annual,2311582,2227846,83736,3.6
Colorado,1999,Annual,2344282,2272197,72085,3.1
Colorado,2000,Annual,2359515,2294408,65107,2.8
Colorado,2001,Annual,2391048,2300113,90935,3.8
Colorado,2002,Annual,2442992,2307685,135307,5.5
Colorado,2003,Annual,2486229,2338207,148022,6.0
Colorado,2004,Annual,2532361,2393559,138802,5.5
Colorado,2005,Annual,2563900,2435082,128818,5.0
Colorado,2006,Annual,2622243,2509729,112514,4.3
Colorado,2007,Annual,2664677,2565218,99459,3.7
Colorado,2008,Annual,2716625,2585243,131382,4.8
Colorado,2009,Annual,2722982,2524443,198539,7.3
Colorado,2010,Annual,2724417,2486404,238013,8.7
Colorado,2011,Annual,2736079,2507265,228814,8.4
Colorado,2012,Annual,2757222,2539941,217281,7.9
Colorado,2013,Annual,2767153,2577556,189597,6.9
Colorado,2014,Annual,2799491,2659474,140017,5.0
Colorado,2015,Annual,2824759,2715059,109700,3.9
Colorado,2016,Annual,2893268,2798928,94340,3.3
Colorado,2017,Annual,2992307,2907468,84839,2.8
Connecticut,1976,Annual,1455740,1320510,135230,9.3
Connecticut,1977,Annual,1484885,1380972,103913,7.0
Connecticut,1978,Annual,1513504,1434580,78924,5.2
Connecticut,1979,Annual,1562654,1482436,80218,5.1
Connecticut,1980,Annual,1588290,1496088,92202,5.8
Connecticut,1981,Annual,1596437,1497809,98628,6.2
Connecticut,1982,Annual,1608804,1498489,110315,6.9
Connecticut,1983,Annual,1619703,1522446,97257,6.0
Connecticut,1984,Annual,1663064,1585450,77614,4.7
Connecticut,1985,Annual,1710255,1629294,80961,4.7
Connecticut,1986,Annual,1737273,1670498,66775,3.8
Connecticut,1987,Annual,1750361,1691514,58847,3.4
Connecticut,1988,Annual,1746643,1694869,51774,3.0
Connecticut,1989,Annual,1772352,1705616,66736,3.8
Connecticut,1990,Annual,1819775,1726482,93293,5.1
Connecticut,1991,Annual,1841104,1720656,120448,6.5
Connecticut,1992,Annual,1827707,1689684,138023,7.6
Connecticut,1993,Annual,1795716,1676578,119138,6.6
Connecticut,1994,Annual,1756296,1657825,98471,5.6
Connecticut,1995,Annual,1734064,1639060,95004,5.5
Connecticut,1996,Annual,1741727,1645952,95775,5.5
Connecticut,1997,Annual,1752540,1664912,87628,5.0
Connecticut,1998,Annual,1742196,1682342,59854,3.4
Connecticut,1999,Annual,1754565,1704134,50431,2.9
Connecticut,2000,Annual,1764126,1721913,42213,2.4
Connecticut,2001,Annual,1759829,1704774,55055,3.1
Connecticut,2002,Annual,1774152,1697127,77025,4.3
Connecticut,2003,Annual,1784260,1687924,96336,5.4
Connecticut,2004,Annual,1774193,1686213,87980,5.0
Connecticut,2005,Annual,1796976,1709382,87594,4.9
Connecticut,2006,Annual,1828651,1749191,79460,4.3
Connecticut,2007,Annual,1856209,1773159,83050,4.5
Connecticut,2008,Annual,1881454,1774681,106773,5.7
Connecticut,2009,Annual,1891077,1740971,150106,7.9
Connecticut,2010,Annual,1911712,1737449,174263,9.1
Connecticut,2011,Annual,1914775,1745967,168808,8.8
Connecticut,2012,Annual,1887419,1729838,157581,8.3
Connecticut,2013,Annual,1863337,1717764,145573,7.8
Connecticut,2014,Annual,1892451,1767282,125169,6.6
Connecticut,2015,Annual,1895832,1787434,108398,5.7
Connecticut,2016,Annual,1904556,1806575,97981,5.1
Connecticut,2017,Annual,1918576,1828858,89718,4.7
Delaware,1976,Annual,264791,241614,23177,8.8
Delaware,1977,Annual,272833,249732,23101,8.5
Delaware,1978,Annual,277334,256771,20563,7.4
Delaware,1979,Annual,280816,260517,20299,7.2
Delaware,1980,Annual,283955,262384,21571,7.6
Delaware,1981,Annual,287919,265348,22571,7.8
Delaware,1982,Annual,294391,269723,24668,8.4
Delaware,1983,Annual,296258,273360,22898,7.7
Delaware,1984,Annual,307185,287859,19326,6.3
Delaware,1985,Annual,316652,300368,16284,5.1
Delaware,1986,Annual,324857,310780,14077,4.3
Delaware,1987,Annual,332990,322702,10288,3.1
Delaware,1988,Annual,348445,337484,10961,3.1
Delaware,1989,Annual,359658,347126,12532,3.5
Delaware,1990,Annual,360223,343199,17024,4.7
Delaware,1991,Annual,361714,339303,22411,6.2
Delaware,1992,Annual,367162,347253,19909,5.4
Delaware,1993,Annual,376854,357777,19077,5.1
Delaware,1994,Annual,384827,366324,18503,4.8
Delaware,1995,Annual,385838,369200,16638,4.3
Delaware,1996,Annual,388134,368254,19880,5.1
Delaware,1997,Annual,387597,372144,15453,4
Delaware,1998,Annual,394889,380250,14639,3.7
Delaware,1999,Annual,398783,385190,13593,3.4
Delaware,2000,Annual,413500,398027,15473,3.7
Delaware,2001,Annual,421786,407033,14753,3.5
Delaware,2002,Annual,416783,400019,16764,4
Delaware,2003,Annual,415160,397472,17688,4.3
Delaware,2004,Annual,420384,403599,16785,4
Delaware,2005,Annual,432409,414465,17944,4.1
Delaware,2006,Annual,441184,425399,15785,3.6
Delaware,2007,Annual,443573,428312,15261,3.4
Delaware,2008,Annual,447041,424914,22127,4.9
Delaware,2009,Annual,437500,401312,36188,8.3
Delaware,2010,Annual,434419,397869,36550,8.4
Delaware,2011,Annual,443346,410086,33260,7.5
Delaware,2012,Annual,445572,413457,32115,7.2
Delaware,2013,Annual,442728,413119,29609,6.7
Delaware,2014,Annual,453312,427386,25926,5.7
Delaware,2015,Annual,467110,444404,22706,4.9
Delaware,2016,Annual,473881,452434,21447,4.5
Delaware,2017,Annual,477349,455427,21922,4.6
District of Columbia,1976,Annual,335284,305107,30177,9.0
District of Columbia,1977,Annual,330279,300034,30245,9.2
District of Columbia,1978,Annual,334729,307055,27674,8.3
District of Columbia,1979,Annual,328952,305804,23148,7.0
District of Columbia,1980,Annual,321997,298261,23736,7.4
District of Columbia,1981,Annual,306560,279230,27330,8.9
District of Columbia,1982,Annual,307539,275427,32112,10.4
District of Columbia,1983,Annual,316481,280937,35544,11.2
District of Columbia,1984,Annual,321549,292134,29415,9.1
District of Columbia,1985,Annual,323655,297291,26364,8.1
District of Columbia,1986,Annual,323379,299015,24364,7.5
District of Columbia,1987,Annual,330066,309197,20869,6.3
District of Columbia,1988,Annual,329849,313257,16592,5.0
District of Columbia,1989,Annual,314700,299255,15445,4.9
District of Columbia,1990,Annual,328924,308281,20643,6.3
District of Columbia,1991,Annual,321433,296477,24956,7.8
District of Columbia,1992,Annual,317226,289953,27273,8.6
District of Columbia,1993,Annual,315856,288925,26931,8.5
District of Columbia,1994,Annual,310532,285776,24756,8.0
District of Columbia,1995,Annual,300085,273768,26317,8.8
District of Columbia,1996,Annual,287378,263163,24215,8.4
District of Columbia,1997,Annual,282744,260105,22639,8.0
District of Columbia,1998,Annual,291902,267312,24590,8.4
District of Columbia,1999,Annual,306131,286650,19481,6.4
District of Columbia,2000,Annual,310469,293086,17383,5.6
District of Columbia,2001,Annual,310515,290811,19704,6.3
District of Columbia,2002,Annual,306099,286496,19603,6.4
District of Columbia,2003,Annual,306422,285454,20968,6.8
District of Columbia,2004,Annual,312027,287683,24344,7.8
District of Columbia,2005,Annual,315616,295484,20132,6.4
District of Columbia,2006,Annual,316083,297786,18297,5.8
District of Columbia,2007,Annual,322237,304426,17811,5.5
District of Columbia,2008,Annual,330544,309192,21352,6.5
District of Columbia,2009,Annual,335672,304500,31172,9.3
District of Columbia,2010,Annual,346065,313508,32557,9.4
District of Columbia,2011,Annual,350778,315171,35607,10.2
District of Columbia,2012,Annual,364989,331984,33005,9.0
District of Columbia,2013,Annual,374126,342351,31775,8.5
District of Columbia,2014,Annual,378380,348981,29399,7.8
District of Columbia,2015,Annual,388057,361324,26733,6.9
District of Columbia,2016,Annual,394586,370521,24065,6.1
District of Columbia,2017,Annual,400894,376633,24261,6.1
Florida,1976,Annual,3602310,3272065,330245,9.2
Florida,1977,Annual,3724245,3419987,304258,8.2
Florida,1978,Annual,3962454,3695902,266552,6.7
Florida,1979,Annual,4135752,3890380,245372,5.9
Florida,1980,Annual,4274346,4014765,259581,6.1
Florida,1981,Annual,4527425,4224775,302650,6.7
Florida,1982,Annual,4729458,4330894,398564,8.4
Florida,1983,Annual,4927448,4508687,418761,8.5
Florida,1984,Annual,5161635,4832656,328979,6.4
Florida,1985,Annual,5342656,5023378,319278,6.0
Florida,1986,Annual,5590997,5267509,323488,5.8
Florida,1987,Annual,5859869,5549518,310351,5.3
Florida,1988,Annual,6054325,5744058,310267,5.1
Florida,1989,Annual,6237743,5890508,347235,5.6
Florida,1990,Annual,6464169,6068832,395337,6.1
Florida,1991,Annual,6532429,6040216,492213,7.5
Florida,1992,Annual,6657112,6108967,548145,8.2
Florida,1993,Annual,6756534,6274934,481600,7.1
Florida,1994,Annual,6947512,6499945,447567,6.4
Florida,1995,Annual,7046151,6656533,389618,5.5
Florida,1996,Annual,7169990,6800128,369862,5.2
Florida,1997,Annual,7368111,7015836,352275,4.8
Florida,1998,Annual,7521469,7196659,324810,4.3
Florida,1999,Annual,7657159,7359460,297699,3.9
Florida,2000,Annual,7856895,7565981,290914,3.7
Florida,2001,Annual,8043714,7669117,374597,4.7
Florida,2002,Annual,8114409,7656349,458060,5.6
Florida,2003,Annual,8210696,7783148,427548,5.2
Florida,2004,Annual,8440428,8049908,390520,4.6
Florida,2005,Annual,8720970,8398974,321996,3.7
Florida,2006,Annual,9000204,8709522,290682,3.2
Florida,2007,Annual,9157124,8789770,367354,4.0
Florida,2008,Annual,9215524,8637164,578360,6.3
Florida,2009,Annual,9094825,8148123,946702,10.4
Florida,2010,Annual,9212066,8193659,1018407,11.1
Florida,2011,Annual,9300542,8371638,928904,10.0
Florida,2012,Annual,9382993,8588669,794324,8.5
Florida,2013,Annual,9453747,8770084,683663,7.2
Florida,2014,Annual,9581083,8979399,601684,6.3
Florida,2015,Annual,9629632,9104357,525275,5.5
Florida,2016,Annual,9846000,9373059,472941,4.8
Florida,2017,Annual,10100266,9680820,419446,4.2
Georgia,1976,Annual,2273932,2087587,186345,8.2
Georgia,1977,Annual,2332184,2171434,160750,6.9
Georgia,1978,Annual,2410909,2272970,137939,5.7
Georgia,1979,Annual,2467596,2341422,126174,5.1
Georgia,1980,Annual,2533586,2373390,160196,6.3
Georgia,1981,Annual,2600075,2434001,166074,6.4
Georgia,1982,Annual,2655895,2448223,207672,7.8
Georgia,1983,Annual,2692349,2484166,208183,7.7
Georgia,1984,Annual,2769779,2601033,168746,6.1
Georgia,1985,Annual,2877663,2692830,184833,6.4
Georgia,1986,Annual,2982631,2804930,177701,6.0
Georgia,1987,Annual,3063215,2889508,173707,5.7
Georgia,1988,Annual,3144406,2964789,179617,5.7
Georgia,1989,Annual,3208446,3031606,176840,5.5
Georgia,1990,Annual,3283912,3104564,179348,5.5
Georgia,1991,Annual,3278409,3108166,170243,5.2
Georgia,1992,Annual,3399695,3164618,235077,6.9
Georgia,1993,Annual,3480778,3271285,209493,6.0
Georgia,1994,Annual,3593963,3406072,187891,5.2
Georgia,1995,Annual,3682926,3504765,178161,4.8
Georgia,1996,Annual,3810136,3632917,177219,4.7
Georgia,1997,Annual,3960492,3779217,181275,4.6
Georgia,1998,Annual,4072762,3898825,173937,4.3
Georgia,1999,Annual,4153499,3990393,163106,3.9
Georgia,2000,Annual,4222253,4071557,150696,3.6
Georgia,2001,Annual,4262041,4089559,172482,4.0
Georgia,2002,Annual,4327691,4110874,216817,5.0
Georgia,2003,Annual,4394437,4182521,211916,4.8
Georgia,2004,Annual,4451800,4239065,212735,4.8
Georgia,2005,Annual,4586420,4341223,245197,5.3
Georgia,2006,Annual,4710775,4489128,221647,4.7
Georgia,2007,Annual,4815818,4597640,218178,4.5
Georgia,2008,Annual,4879253,4575010,304243,6.2
Georgia,2009,Annual,4787749,4311854,475895,9.9
Georgia,2010,Annual,4696676,4202052,494624,10.5
Georgia,2011,Annual,4748754,4263305,485449,10.2
Georgia,2012,Annual,4787367,4348083,439284,9.2
Georgia,2013,Annual,4756157,4366374,389783,8.2
Georgia,2014,Annual,4752639,4416145,336494,7.1
Georgia,2015,Annual,4788858,4503150,285708,6.0
Georgia,2016,Annual,4926945,4662849,264096,5.4
Georgia,2017,Annual,5061399,4821622,239777,4.7
Hawaii,1976,Annual,409847,371344,38503,9.4
Hawaii,1977,Annual,416882,384049,32833,7.9
Hawaii,1978,Annual,418444,388852,29592,7.1
Hawaii,1979,Annual,425536,399647,25889,6.1
Hawaii,1980,Annual,438848,416797,22051,5.0
Hawaii,1981,Annual,450177,425803,24374,5.4
Hawaii,1982,Annual,458778,429816,28962,6.3
Hawaii,1983,Annual,471578,442480,29098,6.2
Hawaii,1984,Annual,472988,446129,26859,5.7
Hawaii,1985,Annual,479158,453370,25788,5.4
Hawaii,1986,Annual,491387,467935,23452,4.8
Hawaii,1987,Annual,510628,491212,19416,3.8
Hawaii,1988,Annual,517775,501341,16434,3.2
Hawaii,1989,Annual,527490,514168,13322,2.5
Hawaii,1990,Annual,550921,536216,14705,2.7
Hawaii,1991,Annual,571588,555187,16401,2.9
Hawaii,1992,Annual,584253,558936,25317,4.3
Hawaii,1993,Annual,586404,560114,26290,4.5
Hawaii,1994,Annual,585215,552917,32298,5.5
Hawaii,1995,Annual,586481,552009,34472,5.9
Hawaii,1996,Annual,595598,558167,37431,6.3
Hawaii,1997,Annual,600954,563580,37374,6.2
Hawaii,1998,Annual,601583,564957,36626,6.1
Hawaii,1999,Annual,602907,570394,32513,5.4
Hawaii,2000,Annual,605947,580214,25733,4.2
Hawaii,2001,Annual,610630,583187,27443,4.5
Hawaii,2002,Annual,600924,575594,25330,4.2
Hawaii,2003,Annual,603122,578323,24799,4.1
Hawaii,2004,Annual,610912,590156,20756,3.4
Hawaii,2005,Annual,626912,608957,17955,2.9
Hawaii,2006,Annual,638260,621573,16687,2.6
Hawaii,2007,Annual,638395,620535,17860,2.8
Hawaii,2008,Annual,639691,612120,27571,4.3
Hawaii,2009,Annual,631690,586522,45168,7.2
Hawaii,2010,Annual,647249,602282,44967,6.9
Hawaii,2011,Annual,660253,615319,44934,6.8
Hawaii,2012,Annual,647185,608302,38883,6.0
Hawaii,2013,Annual,651557,619691,31866,4.9
Hawaii,2014,Annual,666674,637661,29013,4.4
Hawaii,2015,Annual,675506,651459,24047,3.6
Hawaii,2016,Annual,684167,664032,20135,2.9
Hawaii,2017,Annual,685418,669241,16177,2.4
Idaho,1976,Annual,373138,352371,20767,5.6
Idaho,1977,Annual,397769,374822,22947,5.8
Idaho,1978,Annual,416943,394249,22694,5.4
Idaho,1979,Annual,429329,404370,24959,5.8
Idaho,1980,Annual,428739,396448,32291,7.5
Idaho,1981,Annual,430350,397016,33334,7.7
Idaho,1982,Annual,442756,398783,43973,9.9
Idaho,1983,Annual,453993,413403,40590,8.9
Idaho,1984,Annual,462704,428843,33861,7.3
Idaho,1985,Annual,466588,429858,36730,7.9
Idaho,1986,Annual,471760,431928,39832,8.4
Idaho,1987,Annual,470758,434907,35851,7.6
Idaho,1988,Annual,479124,450247,28877,6.0
Idaho,1989,Annual,489473,463567,25906,5.3
Idaho,1990,Annual,492490,465255,27235,5.5
Idaho,1991,Annual,508081,476505,31576,6.2
Idaho,1992,Annual,531126,497372,33754,6.4
Idaho,1993,Annual,554106,520963,33143,6.0
Idaho,1994,Annual,587134,555338,31796,5.4
Idaho,1995,Annual,600704,568218,32486,5.4
Idaho,1996,Annual,616791,584137,32654,5.3
Idaho,1997,Annual,633725,601135,32590,5.1
Idaho,1998,Annual,649435,616282,33153,5.1
Idaho,1999,Annual,651207,619237,31970,4.9
Idaho,2000,Annual,659824,628844,30980,4.7
Idaho,2001,Annual,677665,643280,34385,5.1
Idaho,2002,Annual,684591,646549,38042,5.6
Idaho,2003,Annual,690005,651335,38670,5.6
Idaho,2004,Annual,703062,668441,34621,4.9
Idaho,2005,Annual,731670,702291,29379,4.0
Idaho,2006,Annual,747377,721346,26031,3.5
Idaho,2007,Annual,754438,731235,23203,3.1
Idaho,2008,Annual,755153,716653,38500,5.1
Idaho,2009,Annual,757131,690722,66409,8.8
Idaho,2010,Annual,761056,692826,68230,9.0
Idaho,2011,Annual,765178,701466,63712,8.3
Idaho,2012,Annual,769256,713704,55552,7.2
Idaho,2013,Annual,770833,723636,47197,6.1
Idaho,2014,Annual,779631,741525,38106,4.9
Idaho,2015,Annual,794675,761009,33666,4.2
Idaho,2016,Annual,812856,782279,30577,3.8
Idaho,2017,Annual,833462,807163,26299,3.2
Illinois,1976,Annual,5149989,4808498,341491,6.6
Illinois,1977,Annual,5281924,4955219,326705,6.2
Illinois,1978,Annual,5422862,5098059,324803,6.0
Illinois,1979,Annual,5448408,5147184,301224,5.5
Illinois,1980,Annual,5554539,5101693,452846,8.2
Illinois,1981,Annual,5592209,5114483,477726,8.5
Illinois,1982,Annual,5614249,4976383,637866,11.4
Illinois,1983,Annual,5603113,4943293,659820,11.8
Illinois,1984,Annual,5611290,5104429,506861,9.0
Illinois,1985,Annual,5672208,5158654,513554,9.1
Illinois,1986,Annual,5694686,5223314,471372,8.3
Illinois,1987,Annual,5756424,5327984,428440,7.4
Illinois,1988,Annual,5849194,5458962,390232,6.7
Illinois,1989,Annual,5994211,5632943,361268,6.0
Illinois,1990,Annual,5947011,5581864,365147,6.1
Illinois,1991,Annual,5944289,5513326,430963,7.3
Illinois,1992,Annual,6027916,5552539,475377,7.9
Illinois,1993,Annual,6072484,5620733,451751,7.4
Illinois,1994,Annual,6108648,5755545,353103,5.8
Illinois,1995,Annual,6174337,5855655,318682,5.2
Illinois,1996,Annual,6247845,5917463,330382,5.3
Illinois,1997,Annual,6300928,5999611,301317,4.8
Illinois,1998,Annual,6347005,6066484,280521,4.4
Illinois,1999,Annual,6467988,6186543,281445,4.4
Illinois,2000,Annual,6493466,6211404,282062,4.3
Illinois,2001,Annual,6457922,6113677,344245,5.3
Illinois,2002,Annual,6349239,5933897,415342,6.5
Illinois,2003,Annual,6300221,5874608,425613,6.8
Illinois,2004,Annual,6325447,5933127,392320,6.2
Illinois,2005,Annual,6397808,6033913,363895,5.7
Illinois,2006,Annual,6526273,6230845,295428,4.5
Illinois,2007,Annual,6665601,6334010,331591,5.0
Illinois,2008,Annual,6657227,6238611,418616,6.3
Illinois,2009,Annual,6618658,5943229,675429,10.2
Illinois,2010,Annual,6625321,5937047,688274,10.4
Illinois,2011,Annual,6586893,5948366,638527,9.7
Illinois,2012,Annual,6581867,5990644,591223,9.0
Illinois,2013,Annual,6549473,5956749,592724,9.0
Illinois,2014,Annual,6508356,6047243,461113,7.1
Illinois,2015,Annual,6507228,6119271,387957,6.0
Illinois,2016,Annual,6549991,6169560,380431,5.8
Illinois,2017,Annual,6492578,6170676,321902,5.0
Indiana,1976,Annual,2434546,2287000,147546,6.1
Indiana,1977,Annual,2490170,2345816,144354,5.8
Indiana,1978,Annual,2590145,2445385,144760,5.6
Indiana,1979,Annual,2636428,2465575,170853,6.5
Indiana,1980,Annual,2625544,2372211,253333,9.6
Indiana,1981,Annual,2617959,2359393,258566,9.9
Indiana,1982,Annual,2599391,2288032,311359,12.0
Indiana,1983,Annual,2583412,2294337,289075,11.2
Indiana,1984,Annual,2631866,2406827,225039,8.6
Indiana,1985,Annual,2710413,2499152,211261,7.8
Indiana,1986,Annual,2748410,2560101,188309,6.9
Indiana,1987,Annual,2757863,2585927,171936,6.2
Indiana,1988,Annual,2805683,2658707,146976,5.2
Indiana,1989,Annual,2856099,2717574,138525,4.9
Indiana,1990,Annual,2814608,2666066,148542,5.3
Indiana,1991,Annual,2792829,2626154,166675,6.0
Indiana,1992,Annual,2857384,2669811,187573,6.6
Indiana,1993,Annual,2948307,2789531,158776,5.4
Indiana,1994,Annual,3064328,2915071,149257,4.9
Indiana,1995,Annual,3135172,2991096,144076,4.6
Indiana,1996,Annual,3109669,2983209,126460,4.1
Indiana,1997,Annual,3120608,3011304,109304,3.5
Indiana,1998,Annual,3123160,3026444,96716,3.1
Indiana,1999,Annual,3124851,3029834,95017,3.0
Indiana,2000,Annual,3126379,3029073,97306,3.1
Indiana,2001,Annual,3140899,3007507,133392,4.2
Indiana,2002,Annual,3171168,3006811,164357,5.2
Indiana,2003,Annual,3182988,3014655,168333,5.3
Indiana,2004,Annual,3167797,2998068,169729,5.4
Indiana,2005,Annual,3205436,3029959,175477,5.5
Indiana,2006,Annual,3235110,3072113,162997,5.0
Indiana,2007,Annual,3207687,3061042,146645,4.6
Indiana,2008,Annual,3232097,3041828,190269,5.9
Indiana,2009,Annual,3193989,2864985,329004,10.3
Indiana,2010,Annual,3175192,2845608,329584,10.4
Indiana,2011,Annual,3181991,2891945,290046,9.1
Indiana,2012,Annual,3169835,2905549,264286,8.3
Indiana,2013,Annual,3188406,2944275,244131,7.7
Indiana,2014,Annual,3224871,3032693,192178,6.0
Indiana,2015,Annual,3267121,3109362,157759,4.8
Indiana,2016,Annual,3327139,3180104,147035,4.4
Indiana,2017,Annual,3320409,3203351,117058,3.5
Iowa,1976,Annual,1338074,1284487,53587,4.0
Iowa,1977,Annual,1384889,1330944,53945,3.9
Iowa,1978,Annual,1418036,1363245,54791,3.9
Iowa,1979,Annual,1421489,1361679,59810,4.2
Iowa,1980,Annual,1435156,1348855,86301,6.0
Iowa,1981,Annual,1426591,1332833,93758,6.6
Iowa,1982,Annual,1424383,1303292,121091,8.5
Iowa,1983,Annual,1422636,1307170,115466,8.1
Iowa,1984,Annual,1415875,1317125,98750,7.0
Iowa,1985,Annual,1413046,1307423,105623,7.5
Iowa,1986,Annual,1433643,1336751,96892,6.8
Iowa,1987,Annual,1452988,1373229,79759,5.5
Iowa,1988,Annual,1491110,1424110,67000,4.5
Iowa,1989,Annual,1508708,1445448,63260,4.2
Iowa,1990,Annual,1451750,1387668,64082,4.4
Iowa,1991,Annual,1474789,1406164,68625,4.7
Iowa,1992,Annual,1511801,1444325,67476,4.5
Iowa,1993,Annual,1559713,1496789,62924,4.0
Iowa,1994,Annual,1579261,1523726,55535,3.5
Iowa,1995,Annual,1587051,1532400,54651,3.4
Iowa,1996,Annual,1608348,1551711,56637,3.5
Iowa,1997,Annual,1602935,1552946,49989,3.1
Iowa,1998,Annual,1595942,1552120,43822,2.7
Iowa,1999,Annual,1596414,1555090,41324,2.6
Iowa,2000,Annual,1590453,1548636,41817,2.6
Iowa,2001,Annual,1612964,1559241,53723,3.3
Iowa,2002,Annual,1637909,1572560,65349,4.0
Iowa,2003,Annual,1606798,1534489,72309,4.5
Iowa,2004,Annual,1601788,1529761,72027,4.5
Iowa,2005,Annual,1629764,1560169,69595,4.3
Iowa,2006,Annual,1657584,1596530,61054,3.7
Iowa,2007,Annual,1660677,1599332,61345,3.7
Iowa,2008,Annual,1679293,1608695,70598,4.2
Iowa,2009,Annual,1687411,1579248,108163,6.4
Iowa,2010,Annual,1678281,1577447,100834,6.0
Iowa,2011,Annual,1662376,1570177,92199,5.5
Iowa,2012,Annual,1653141,1569879,83262,5.0
Iowa,2013,Annual,1674190,1594891,79299,4.7
Iowa,2014,Annual,1700756,1628505,72251,4.2
Iowa,2015,Annual,1701317,1637118,64199,3.8
Iowa,2016,Annual,1696113,1634964,61149,3.6
Iowa,2017,Annual,1678549,1626036,52513,3.1
Kansas,1976,Annual,1071376,1026187,45189,4.2
Kansas,1977,Annual,1105749,1062496,43253,3.9
Kansas,1978,Annual,1139699,1104141,35558,3.1
Kansas,1979,Annual,1169991,1132264,37727,3.2
Kansas,1980,Annual,1187425,1134614,52811,4.4
Kansas,1981,Annual,1187080,1135918,51162,4.3
Kansas,1982,Annual,1193568,1118684,74884,6.3
Kansas,1983,Annual,1188919,1119214,69705,5.9
Kansas,1984,Annual,1203358,1144423,58935,4.9
Kansas,1985,Annual,1228017,1165356,62661,5.1
Kansas,1986,Annual,1241711,1175560,66151,5.3
Kansas,1987,Annual,1262821,1201769,61052,4.8
Kansas,1988,Annual,1276496,1218556,57940,4.5
Kansas,1989,Annual,1284372,1230713,53659,4.2
Kansas,1990,Annual,1272519,1217887,54632,4.3
Kansas,1991,Annual,1279949,1223430,56519,4.4
Kansas,1992,Annual,1308836,1250194,58642,4.5
Kansas,1993,Annual,1333092,1266875,66217,5.0
Kansas,1994,Annual,1348851,1282791,66060,4.9
Kansas,1995,Annual,1349748,1290159,59589,4.4
Kansas,1996,Annual,1358124,1300384,57740,4.3
Kansas,1997,Annual,1381702,1329751,51951,3.8
Kansas,1998,Annual,1416392,1366403,49989,3.5
Kansas,1999,Annual,1425599,1378867,46732,3.3
Kansas,2000,Annual,1406580,1356147,50433,3.6
Kansas,2001,Annual,1390620,1332034,58586,4.2
Kansas,2002,Annual,1413014,1341603,71411,5.1
Kansas,2003,Annual,1437027,1357867,79160,5.5
Kansas,2004,Annual,1463707,1383867,79840,5.5
Kansas,2005,Annual,1465640,1392024,73616,5.0
Kansas,2006,Annual,1467095,1402796,64299,4.4
Kansas,2007,Annual,1483458,1420449,63009,4.2
Kansas,2008,Annual,1499676,1430628,69048,4.6
Kansas,2009,Annual,1518207,1413873,104334,6.9
Kansas,2010,Annual,1500764,1394958,105806,7.1
Kansas,2011,Annual,1491087,1394082,97005,6.5
Kansas,2012,Annual,1485220,1400122,85098,5.7
Kansas,2013,Annual,1485917,1407217,78700,5.3
Kansas,2014,Annual,1491710,1424016,67694,4.5
Kansas,2015,Annual,1489829,1427731,62098,4.2
Kansas,2016,Annual,1485336,1425413,59923,4.0
Kansas,2017,Annual,1478783,1425216,53567,3.6
Kentucky,1976,Annual,1494225,1413569,80656,5.4
Kentucky,1977,Annual,1536657,1462344,74313,4.8
Kentucky,1978,Annual,1583514,1502034,81480,5.1
Kentucky,1979,Annual,1616350,1526836,89514,5.5
Kentucky,1980,Annual,1658824,1526920,131904,8.0
Kentucky,1981,Annual,1665577,1521899,143678,8.6
Kentucky,1982,Annual,1683086,1501527,181559,10.8
Kentucky,1983,Annual,1702034,1507804,194230,11.4
Kentucky,1984,Annual,1704246,1546319,157927,9.3
Kentucky,1985,Annual,1694398,1538028,156370,9.2
Kentucky,1986,Annual,1693468,1534414,159054,9.4
Kentucky,1987,Annual,1692290,1548994,143296,8.5
Kentucky,1988,Annual,1712328,1581966,130362,7.6
Kentucky,1989,Annual,1736251,1625834,110417,6.4
Kentucky,1990,Annual,1754358,1649657,104701,6.0
Kentucky,1991,Annual,1762723,1634245,128478,7.3
Kentucky,1992,Annual,1778852,1656436,122416,6.9
Kentucky,1993,Annual,1803302,1691208,112094,6.2
Kentucky,1994,Annual,1826236,1727832,98404,5.4
Kentucky,1995,Annual,1855545,1755029,100516,5.4
Kentucky,1996,Annual,1874089,1771621,102468,5.5
Kentucky,1997,Annual,1916745,1814492,102253,5.3
Kentucky,1998,Annual,1932757,1844022,88735,4.6
Kentucky,1999,Annual,1959402,1870873,88529,4.5
Kentucky,2000,Annual,1965688,1883714,81974,4.2
Kentucky,2001,Annual,1958409,1857238,101171,5.2
Kentucky,2002,Annual,1944020,1833535,110485,5.7
Kentucky,2003,Annual,1960045,1839873,120172,6.1
Kentucky,2004,Annual,1963875,1857816,106059,5.4
Kentucky,2005,Annual,1999777,1881943,117834,5.9
Kentucky,2006,Annual,2029231,1913472,115759,5.7
Kentucky,2007,Annual,2032082,1922220,109862,5.4
Kentucky,2008,Annual,2030738,1900683,130055,6.4
Kentucky,2009,Annual,2060162,1847126,213036,10.3
Kentucky,2010,Annual,2054375,1844650,209725,10.2
Kentucky,2011,Annual,2056410,1862928,193482,9.4
Kentucky,2012,Annual,2059127,1891162,167965,8.2
Kentucky,2013,Annual,2055442,1890879,164563,8.0
Kentucky,2014,Annual,2003842,1874516,129326,6.5
Kentucky,2015,Annual,1976967,1872326,104641,5.3
Kentucky,2016,Annual,2012279,1909158,103121,5.1
Kentucky,2017,Annual,2052368,1952066,100302,4.9
Louisiana,1976,Annual,1527236,1424855,102381,6.7
Louisiana,1977,Annual,1599156,1485953,113203,7.1
Louisiana,1978,Annual,1668701,1555535,113166,6.8
Louisiana,1979,Annual,1726798,1613069,113729,6.6
Louisiana,1980,Annual,1786701,1664309,122392,6.9
Louisiana,1981,Annual,1854541,1699027,155514,8.4
Louisiana,1982,Annual,1867571,1675507,192064,10.3
Louisiana,1983,Annual,1908753,1688598,220155,11.5
Louisiana,1984,Annual,1951326,1754800,196526,10.1
Louisiana,1985,Annual,1985981,1756263,229718,11.6
Louisiana,1986,Annual,1979030,1726694,252336,12.8
Louisiana,1987,Annual,1948253,1711944,236309,12.1
Louisiana,1988,Annual,1920896,1712758,208138,10.8
Louisiana,1989,Annual,1881536,1731388,150148,8.0
Louisiana,1990,Annual,1869848,1753951,115897,6.2
Louisiana,1991,Annual,1907456,1768610,138846,7.3
Louisiana,1992,Annual,1921822,1767337,154485,8.0
Louisiana,1993,Annual,1897952,1753214,144738,7.6
Louisiana,1994,Annual,1943086,1790627,152459,7.8
Louisiana,1995,Annual,1959012,1821954,137058,7.0
Louisiana,1996,Annual,1989219,1857715,131504,6.6
Louisiana,1997,Annual,2021240,1899922,121318,6.0
Louisiana,1998,Annual,2048904,1932134,116770,5.7
Louisiana,1999,Annual,2039045,1935457,103588,5.1
Louisiana,2000,Annual,2037075,1929056,108019,5.3
Louisiana,2001,Annual,2028302,1911818,116484,5.7
Louisiana,2002,Annual,2004222,1881146,123076,6.1
Louisiana,2003,Annual,2018324,1888974,129350,6.4
Louisiana,2004,Annual,2037176,1916536,120640,5.9
Louisiana,2005,Annual,2069403,1921385,148018,7.2
Louisiana,2006,Annual,1988513,1899981,88532,4.5
Louisiana,2007,Annual,2030434,1944038,86396,4.3
Louisiana,2008,Annual,2084835,1982381,102454,4.9
Louisiana,2009,Annual,2064768,1923884,140884,6.8
Louisiana,2010,Annual,2086076,1919852,166224,8.0
Louisiana,2011,Annual,2073217,1911021,162196,7.8
Louisiana,2012,Annual,2080280,1933137,147143,7.1
Louisiana,2013,Annual,2101416,1960539,140877,6.7
Louisiana,2014,Annual,2153613,2016083,137530,6.4
Louisiana,2015,Annual,2162410,2025661,136749,6.3
Louisiana,2016,Annual,2125934,1997358,128576,6.0
Louisiana,2017,Annual,2112320,2004003,108317,5.1
Maine,1976,Annual,477001,435603,41398,8.7
Maine,1977,Annual,479869,440273,39596,8.3
Maine,1978,Annual,483755,452722,31033,6.4
Maine,1979,Annual,497657,463851,33806,6.8
Maine,1980,Annual,505963,467389,38574,7.6
Maine,1981,Annual,509975,472455,37520,7.4
Maine,1982,Annual,518584,475163,43421,8.4
Maine,1983,Annual,535851,491367,44484,8.3
Maine,1984,Annual,547680,513581,34099,6.2
Maine,1985,Annual,551978,521602,30376,5.5
Maine,1986,Annual,562749,533048,29701,5.3
Maine,1987,Annual,584840,559295,25545,4.4
Maine,1988,Annual,598659,576895,21764,3.6
Maine,1989,Annual,614540,589826,24714,4.0
Maine,1990,Annual,633069,599506,33563,5.3
Maine,1991,Annual,645139,596503,48636,7.5
Maine,1992,Annual,644489,597355,47134,7.3
Maine,1993,Annual,628854,583220,45634,7.3
Maine,1994,Annual,621684,578254,43430,7.0
Maine,1995,Annual,637534,599534,38000,6.0
Maine,1996,Annual,656737,622580,34157,5.2
Maine,1997,Annual,656709,623530,33179,5.1
Maine,1998,Annual,653210,623793,29417,4.5
Maine,1999,Annual,668497,642085,26412,4.0
Maine,2000,Annual,678164,655349,22815,3.4
Maine,2001,Annual,674319,648545,25774,3.8
Maine,2002,Annual,675232,645935,29297,4.3
Maine,2003,Annual,683535,649571,33964,5.0
Maine,2004,Annual,686000,654161,31839,4.6
Maine,2005,Annual,697153,663132,34021,4.9
Maine,2006,Annual,701541,669554,31987,4.6
Maine,2007,Annual,700468,667781,32687,4.7
Maine,2008,Annual,701646,663158,38488,5.5
Maine,2009,Annual,696219,639954,56265,8.1
Maine,2010,Annual,695182,638630,56552,8.1
Maine,2011,Annual,699281,644085,55196,7.9
Maine,2012,Annual,702636,650117,52519,7.5
Maine,2013,Annual,705417,658522,46895,6.6
Maine,2014,Annual,696298,657066,39232,5.6
Maine,2015,Annual,683369,653330,30039,4.4
Maine,2016,Annual,692154,665911,26243,3.8
Maine,2017,Annual,700099,677141,22958,3.3
Maryland,1976,Annual,1916398,1789446,126952,6.6
Maryland,1977,Annual,1973483,1848971,124512,6.3
Maryland,1978,Annual,2044558,1932083,112475,5.5
Maryland,1979,Annual,2111836,1989785,122051,5.8
Maryland,1980,Annual,2148225,2007042,141183,6.6
Maryland,1981,Annual,2171319,2013470,157849,7.3
Maryland,1982,Annual,2174978,1994763,180215,8.3
Maryland,1983,Annual,2197036,2042929,154107,7.0
Maryland,1984,Annual,2240006,2119800,120206,5.4
Maryland,1985,Annual,2280057,2174967,105090,4.6
Maryland,1986,Annual,2346980,2239999,106981,4.6
Maryland,1987,Annual,2408210,2303385,104825,4.4
Maryland,1988,Annual,2469123,2364139,104984,4.3
Maryland,1989,Annual,2523885,2427861,96024,3.8
Maryland,1990,Annual,2590052,2474509,115543,4.5
Maryland,1991,Annual,2616556,2456823,159733,6.1
Maryland,1992,Annual,2651353,2471212,180141,6.8
Maryland,1993,Annual,2658444,2494151,164293,6.2
Maryland,1994,Annual,2681591,2540242,141349,5.3
Maryland,1995,Annual,2710626,2574394,136232,5.0
Maryland,1996,Annual,2740602,2602334,138268,5.0
Maryland,1997,Annual,2766990,2629577,137413,5.0
Maryland,1998,Annual,2764180,2642210,121970,4.4
Maryland,1999,Annual,2766119,2667341,98778,3.6
Maryland,2000,Annual,2803685,2703284,100401,3.6
Maryland,2001,Annual,2837985,2724184,113801,4.0
Maryland,2002,Annual,2869954,2742501,127453,4.4
Maryland,2003,Annual,2882219,2754523,127696,4.4
Maryland,2004,Annual,2889324,2766475,122849,4.3
Maryland,2005,Annual,2924546,2803487,121059,4.1
Maryland,2006,Annual,2963866,2849354,114512,3.9
Maryland,2007,Annual,2970094,2867348,102746,3.5
Maryland,2008,Annual,3001953,2874987,126966,4.2
Maryland,2009,Annual,3032700,2820245,212455,7.0
Maryland,2010,Annual,3073826,2838492,235334,7.7
Maryland,2011,Annual,3096561,2872084,224477,7.2
Maryland,2012,Annual,3119647,2902307,217340,7.0
Maryland,2013,Annual,3129352,2923498,205854,6.6
Maryland,2014,Annual,3129933,2947943,181990,5.8
Maryland,2015,Annual,3151142,2990942,160200,5.1
Maryland,2016,Annual,3178646,3037763,140883,4.4
Maryland,2017,Annual,3219455,3086246,133209,4.1
Massachusetts,1976,Annual,2721867,2460095,261772,9.6
Massachusetts,1977,Annual,2763250,2548352,214898,7.8
Massachusetts,1978,Annual,2813748,2638898,174850,6.2
Massachusetts,1979,Annual,2852892,2695749,157143,5.5
Massachusetts,1980,Annual,2868271,2706635,161636,5.6
Massachusetts,1981,Annual,2941642,2751193,190449,6.5
Massachusetts,1982,Annual,2987137,2756493,230644,7.7
Massachusetts,1983,Annual,2996869,2794466,202403,6.8
Massachusetts,1984,Annual,3037295,2892743,144552,4.8
Massachusetts,1985,Annual,3051393,2930523,120870,4.0
Massachusetts,1986,Annual,3066029,2946878,119151,3.9
Massachusetts,1987,Annual,3094323,2993991,100332,3.2
Massachusetts,1988,Annual,3141431,3038826,102605,3.3
Massachusetts,1989,Annual,3175997,3044177,131820,4.2
Massachusetts,1990,Annual,3206383,3004470,201913,6.3
Massachusetts,1991,Annual,3194946,2919503,275443,8.6
Massachusetts,1992,Annual,3181030,2912028,269002,8.5
Massachusetts,1993,Annual,3174301,2952583,221718,7.0
Massachusetts,1994,Annual,3200834,3007359,193475,6.0
Massachusetts,1995,Annual,3214652,3044696,169956,5.3
Massachusetts,1996,Annual,3241366,3097563,143803,4.4
Massachusetts,1997,Annual,3305660,3176134,129526,3.9
Massachusetts,1998,Annual,3340628,3230442,110186,3.3
Massachusetts,1999,Annual,3353865,3247012,106853,3.2
Massachusetts,2000,Annual,3330177,3240245,89932,2.7
Massachusetts,2001,Annual,3381287,3255134,126153,3.7
Massachusetts,2002,Annual,3431082,3250085,180997,5.3
Massachusetts,2003,Annual,3422409,3226981,195428,5.7
Massachusetts,2004,Annual,3395511,3220838,174673,5.1
Massachusetts,2005,Annual,3384116,3220089,164027,4.8
Massachusetts,2006,Annual,3413339,3246316,167023,4.9
Massachusetts,2007,Annual,3426009,3268096,157913,4.6
Massachusetts,2008,Annual,3452468,3261408,191060,5.5
Massachusetts,2009,Annual,3470382,3189010,281372,8.1
Massachusetts,2010,Annual,3480083,3190818,289265,8.3
Massachusetts,2011,Annual,3469308,3217754,251554,7.3
Massachusetts,2012,Annual,3485161,3252531,232630,6.7
Massachusetts,2013,Annual,3512827,3276792,236035,6.7
Massachusetts,2014,Annual,3566237,3361811,204426,5.7
Massachusetts,2015,Annual,3588241,3415874,172367,4.8
Massachusetts,2016,Annual,3611418,3471112,140306,3.9
Massachusetts,2017,Annual,3657173,3521482,135691,3.7
Michigan,1976,Annual,3993535,3618361,375174,9.4
Michigan,1977,Annual,4109934,3772280,337654,8.2
Michigan,1978,Annual,4208346,3914127,294219,7.0
Michigan,1979,Annual,4302204,3967671,334533,7.8
Michigan,1980,Annual,4303606,3773197,530409,12.3
Michigan,1981,Annual,4302873,3768194,534679,12.4
Michigan,1982,Annual,4287138,3627584,659554,15.4
Michigan,1983,Annual,4291139,3674943,616196,14.4
Michigan,1984,Annual,4337979,3851581,486398,11.2
Michigan,1985,Annual,4360316,3926319,433997,10.0
Michigan,1986,Annual,4398541,4010764,387777,8.8
Michigan,1987,Annual,4511201,4136577,374624,8.3
Michigan,1988,Annual,4552889,4211759,341130,7.5
Michigan,1989,Annual,4589440,4262061,327379,7.1
Michigan,1990,Annual,4607247,4255772,351475,7.6
Michigan,1991,Annual,4595664,4172673,422991,9.2
Michigan,1992,Annual,4678258,4258246,420012,9.0
Michigan,1993,Annual,4742463,4400201,342262,7.2
Michigan,1994,Annual,4807898,4519538,288360,6.0
Michigan,1995,Annual,4812501,4558922,253579,5.3
Michigan,1996,Annual,4877630,4638837,238793,4.9
Michigan,1997,Annual,4954558,4743163,211395,4.3
Michigan,1998,Annual,5019762,4824324,195438,3.9
Michigan,1999,Annual,5115757,4925999,189758,3.7
Michigan,2000,Annual,5162774,4976322,186452,3.6
Michigan,2001,Annual,5119956,4854630,265326,5.2
Michigan,2002,Annual,5017141,4702399,314742,6.3
Michigan,2003,Annual,5027859,4667103,360756,7.2
Michigan,2004,Annual,5062376,4705591,356785,7.0
Michigan,2005,Annual,5083130,4738902,344228,6.8
Michigan,2006,Annual,5076656,4721085,355571,7.0
Michigan,2007,Annual,5011120,4658939,352181,7.0
Michigan,2008,Annual,4921466,4529289,392177,8.0
Michigan,2009,Annual,4903544,4233803,669741,13.7
Michigan,2010,Annual,4798954,4194041,604913,12.6
Michigan,2011,Annual,4685164,4198349,486815,10.4
Michigan,2012,Annual,4672695,4246658,426037,9.1
Michigan,2013,Annual,4723945,4308030,415915,8.8
Michigan,2014,Annual,4753626,4409394,344232,7.2
Michigan,2015,Annual,4751234,4493447,257787,5.4
Michigan,2016,Annual,4840281,4599266,241015,5.0
Michigan,2017,Annual,4883815,4657272,226543,4.6
Minnesota,1976,Annual,1852393,1744171,108222,5.8
Minnesota,1977,Annual,1915838,1815013,100825,5.3
Minnesota,1978,Annual,1971339,1895141,76198,3.9
Minnesota,1979,Annual,2046335,1959937,86398,4.2
Minnesota,1980,Annual,2104800,1983321,121479,5.8
Minnesota,1981,Annual,2122138,1998992,123146,5.8
Minnesota,1982,Annual,2153900,1983510,170390,7.9
Minnesota,1983,Annual,2175118,2001040,174078,8.0
Minnesota,1984,Annual,2202696,2064312,138384,6.3
Minnesota,1985,Annual,2228246,2094586,133660,6.0
Minnesota,1986,Annual,2241061,2117295,123766,5.5
Minnesota,1987,Annual,2280674,2163788,116886,5.1
Minnesota,1988,Annual,2307357,2208614,98743,4.3
Minnesota,1989,Annual,2351967,2250011,101956,4.3
Minnesota,1990,Annual,2398899,2284147,114752,4.8
Minnesota,1991,Annual,2427606,2302626,124980,5.1
Minnesota,1992,Annual,2468394,2342262,126132,5.1
Minnesota,1993,Annual,2516375,2391535,124840,5.0
Minnesota,1994,Annual,2556437,2452054,104383,4.1
Minnesota,1995,Annual,2604291,2506965,97326,3.7
Minnesota,1996,Annual,2652527,2547696,104831,4.0
Minnesota,1997,Annual,2679234,2591975,87259,3.3
Minnesota,1998,Annual,2711784,2638721,73063,2.7
Minnesota,1999,Annual,2756145,2680029,76116,2.8
Minnesota,2000,Annual,2812947,2724118,88829,3.2
Minnesota,2001,Annual,2845203,2737961,107242,3.8
Minnesota,2002,Annual,2859602,2731080,128522,4.5
Minnesota,2003,Annual,2874663,2734287,140376,4.9
Minnesota,2004,Annual,2880428,2745615,134813,4.7
Minnesota,2005,Annual,2879760,2762733,117027,4.1
Minnesota,2006,Annual,2887832,2772115,115717,4.0
Minnesota,2007,Annual,2906390,2773704,132686,4.6
Minnesota,2008,Annual,2925088,2766342,158746,5.4
Minnesota,2009,Annual,2941976,2713426,228550,7.8
Minnesota,2010,Annual,2938795,2721194,217601,7.4
Minnesota,2011,Annual,2946279,2755264,191015,6.5
Minnesota,2012,Annual,2946356,2781141,165215,5.6
Minnesota,2013,Annual,2958596,2811762,146834,5.0
Minnesota,2014,Annual,2973073,2849017,124056,4.2
Minnesota,2015,Annual,2998352,2887683,110669,3.7
Minnesota,2016,Annual,3036278,2919097,117181,3.9
Minnesota,2017,Annual,3063604,2957838,105766,3.5
Mississippi,1976,Annual,969878,906134,63744,6.6
Mississippi,1977,Annual,995545,922787,72758,7.3
Mississippi,1978,Annual,1012078,941880,70198,6.9
Mississippi,1979,Annual,1028571,969475,59096,5.7
Mississippi,1980,Annual,1056820,978337,78483,7.4
Mississippi,1981,Annual,1059321,969271,90050,8.5
Mississippi,1982,Annual,1063553,946018,117535,11.1
Mississippi,1983,Annual,1060755,932775,127980,12.1
Mississippi,1984,Annual,1076818,963398,113420,10.5
Mississippi,1985,Annual,1123857,1007010,116847,10.4
Mississippi,1986,Annual,1152710,1021251,131459,11.4
Mississippi,1987,Annual,1149889,1035177,114712,10.0
Mississippi,1988,Annual,1145759,1049127,96632,8.4
Mississippi,1989,Annual,1165936,1074636,91300,7.8
Mississippi,1990,Annual,1183981,1094036,89945,7.6
Mississippi,1991,Annual,1184038,1082959,101079,8.5
Mississippi,1992,Annual,1190488,1094539,95949,8.1
Mississippi,1993,Annual,1215133,1134735,80398,6.6
Mississippi,1994,Annual,1248762,1170396,78366,6.3
Mississippi,1995,Annual,1258844,1180514,78330,6.2
Mississippi,1996,Annual,1264513,1188212,76301,6.0
Mississippi,1997,Annual,1272802,1200208,72594,5.7
Mississippi,1998,Annual,1274790,1207745,67045,5.3
Mississippi,1999,Annual,1286502,1220702,65800,5.1
Mississippi,2000,Annual,1319266,1248240,71026,5.4
Mississippi,2001,Annual,1294134,1222500,71634,5.5
Mississippi,2002,Annual,1286236,1201191,85045,6.6
Mississippi,2003,Annual,1301250,1219145,82105,6.3
Mississippi,2004,Annual,1313102,1232187,80915,6.2
Mississippi,2005,Annual,1317392,1218825,98567,7.5
Mississippi,2006,Annual,1290171,1205906,84265,6.5
Mississippi,2007,Annual,1303514,1224059,79455,6.1
Mississippi,2008,Annual,1306772,1220991,85781,6.6
Mississippi,2009,Annual,1269219,1148930,120289,9.5
Mississippi,2010,Annual,1306608,1170879,135729,10.4
Mississippi,2011,Annual,1342808,1208747,134061,10.0
Mississippi,2012,Annual,1316536,1198196,118340,9.0
Mississippi,2013,Annual,1272477,1163752,108725,8.5
Mississippi,2014,Annual,1248014,1154058,93956,7.5
Mississippi,2015,Annual,1263925,1182779,81146,6.4
Mississippi,2016,Annual,1278960,1204481,74479,5.8
Mississippi,2017,Annual,1280071,1215115,64956,5.1
Missouri,1976,Annual,2122679,1990253,132426,6.2
Missouri,1977,Annual,2217870,2084319,133551,6.0
Missouri,1978,Annual,2254477,2143700,110777,4.9
Missouri,1979,Annual,2280920,2171188,109732,4.8
Missouri,1980,Annual,2306044,2139848,166196,7.2
Missouri,1981,Annual,2321961,2144518,177443,7.6
Missouri,1982,Annual,2326378,2111744,214634,9.2
Missouri,1983,Annual,2357360,2124824,232536,9.9
Missouri,1984,Annual,2386949,2215940,171009,7.2
Missouri,1985,Annual,2460185,2299301,160884,6.5
Missouri,1986,Annual,2535842,2377984,157858,6.2
Missouri,1987,Annual,2582361,2420322,162039,6.3
Missouri,1988,Annual,2584524,2436775,147749,5.7
Missouri,1989,Annual,2611877,2467177,144700,5.5
Missouri,1990,Annual,2614839,2462267,152572,5.8
Missouri,1991,Annual,2645085,2471095,173990,6.6
Missouri,1992,Annual,2651148,2487204,163944,6.2
Missouri,1993,Annual,2684206,2517067,167139,6.2
Missouri,1994,Annual,2770737,2630692,140045,5.1
Missouri,1995,Annual,2863240,2728231,135009,4.7
Missouri,1996,Annual,2908811,2769622,139189,4.8
Missouri,1997,Annual,2927870,2800544,127326,4.3
Missouri,1998,Annual,2916610,2794971,121639,4.2
Missouri,1999,Annual,2904971,2809325,95646,3.3
Missouri,2000,Annual,2959946,2853891,106055,3.6
Missouri,2001,Annual,3001465,2862838,138627,4.6
Missouri,2002,Annual,3000908,2839467,161441,5.4
Missouri,2003,Annual,3020821,2850987,169834,5.6
Missouri,2004,Annual,3015650,2838872,176778,5.9
Missouri,2005,Annual,3009334,2847006,162328,5.4
Missouri,2006,Annual,3029689,2882757,146932,4.8
Missouri,2007,Annual,3034579,2879647,154932,5.1
Missouri,2008,Annual,3028857,2842845,186012,6.1
Missouri,2009,Annual,3049563,2766711,282852,9.3
Missouri,2010,Annual,3056484,2763535,292949,9.6
Missouri,2011,Annual,3047786,2789224,258562,8.5
Missouri,2012,Annual,3025309,2815275,210034,6.9
Missouri,2013,Annual,3020202,2817435,202767,6.7
Missouri,2014,Annual,3048576,2861721,186855,6.1
Missouri,2015,Annual,3077535,2923107,154428,5.0
Missouri,2016,Annual,3079559,2939309,140250,4.6
Missouri,2017,Annual,3050713,2936126,114587,3.8
Montana,1976,Annual,330284,310614,19670,6.0
Montana,1977,Annual,348883,326918,21965,6.3
Montana,1978,Annual,366065,345148,20917,5.7
Montana,1979,Annual,371332,352135,19197,5.2
Montana,1980,Annual,375691,352700,22991,6.1
Montana,1981,Annual,385038,358686,26352,6.8
Montana,1982,Annual,388809,355711,33098,8.5
Montana,1983,Annual,396719,362488,34231,8.6
Montana,1984,Annual,401741,371262,30479,7.6
Montana,1985,Annual,402891,371962,30929,7.7
Montana,1986,Annual,401814,369942,31872,7.9
Montana,1987,Annual,401148,371312,29836,7.4
Montana,1988,Annual,404629,377736,26893,6.6
Montana,1989,Annual,408809,385154,23655,5.8
Montana,1990,Annual,403136,379100,24036,6.0
Montana,1991,Annual,405837,377804,28033,6.9
Montana,1992,Annual,417467,389391,28076,6.7
Montana,1993,Annual,422646,397102,25544,6.0
Montana,1994,Annual,432281,409630,22651,5.2
Montana,1995,Annual,443172,418081,25091,5.7
Montana,1996,Annual,449306,425468,23838,5.3
Montana,1997,Annual,452708,428555,24153,5.3
Montana,1998,Annual,460394,434868,25526,5.5
Montana,1999,Annual,464373,439993,24380,5.3
Montana,2000,Annual,467293,444137,23156,5.0
Montana,2001,Annual,466063,444909,21154,4.5
Montana,2002,Annual,467203,446640,20563,4.4
Montana,2003,Annual,471489,449266,22223,4.7
Montana,2004,Annual,480281,457423,22858,4.8
Montana,2005,Annual,486054,464907,21147,4.4
Montana,2006,Annual,493614,476377,17237,3.5
Montana,2007,Annual,502070,484189,17881,3.6
Montana,2008,Annual,509163,483347,25816,5.1
Montana,2009,Annual,501014,466713,34301,6.8
Montana,2010,Annual,500525,463998,36527,7.3
Montana,2011,Annual,501225,466403,34822,6.9
Montana,2012,Annual,506485,476174,30311,6.0
Montana,2013,Annual,510781,483071,27710,5.4
Montana,2014,Annual,511501,487629,23872,4.7
Montana,2015,Annual,516845,495298,21547,4.2
Montana,2016,Annual,521628,499990,21638,4.1
Montana,2017,Annual,525453,504279,21174,4.0
Nebraska,1976,Annual,719847,696682,23165,3.2
Nebraska,1977,Annual,741279,715745,25534,3.4
Nebraska,1978,Annual,754549,730851,23698,3.1
Nebraska,1979,Annual,765089,741839,23250,3.0
Nebraska,1980,Annual,769921,739672,30249,3.9
Nebraska,1981,Annual,775186,742310,32876,4.2
Nebraska,1982,Annual,784839,740657,44182,5.6
Nebraska,1983,Annual,787905,744057,43848,5.6
Nebraska,1984,Annual,792288,756844,35444,4.5
Nebraska,1985,Annual,806451,764692,41759,5.2
Nebraska,1986,Annual,808354,767768,40586,5.0
Nebraska,1987,Annual,809864,774141,35723,4.4
Nebraska,1988,Annual,813514,784348,29166,3.6
Nebraska,1989,Annual,816764,792809,23955,2.9
Nebraska,1990,Annual,825024,805708,19316,2.3
Nebraska,1991,Annual,836294,814020,22274,2.7
Nebraska,1992,Annual,847609,823384,24225,2.9
Nebraska,1993,Annual,864394,840575,23819,2.8
Nebraska,1994,Annual,886391,862936,23455,2.6
Nebraska,1995,Annual,902311,878414,23897,2.6
Nebraska,1996,Annual,914379,889438,24941,2.7
Nebraska,1997,Annual,921312,898310,23002,2.5
Nebraska,1998,Annual,930952,907202,23750,2.6
Nebraska,1999,Annual,937559,911444,26115,2.8
Nebraska,2000,Annual,944973,918370,26603,2.8
Nebraska,2001,Annual,950764,921003,29761,3.1
Nebraska,2002,Annual,954224,919401,34823,3.6
Nebraska,2003,Annual,964258,926315,37943,3.9
Nebraska,2004,Annual,969981,932515,37466,3.9
Nebraska,2005,Annual,972992,935906,37086,3.8
Nebraska,2006,Annual,970052,939874,30178,3.1
Nebraska,2007,Annual,978763,949494,29269,3.0
Nebraska,2008,Annual,989757,956759,32998,3.3
Nebraska,2009,Annual,991583,945648,45935,4.6
Nebraska,2010,Annual,993398,947360,46038,4.6
Nebraska,2011,Annual,1003256,959059,44197,4.4
Nebraska,2012,Annual,1014980,974428,40552,4.0
Nebraska,2013,Annual,1018294,979937,38357,3.8
Nebraska,2014,Annual,1011564,978377,33187,3.3
Nebraska,2015,Annual,1007585,977279,30306,3.0
Nebraska,2016,Annual,1008715,977622,31093,3.1
Nebraska,2017,Annual,1007011,977444,29567,2.9
Nevada,1976,Annual,328862,299990,28872,8.8
Nevada,1977,Annual,350339,326855,23484,6.7
Nevada,1978,Annual,373494,356836,16658,4.5
Nevada,1979,Annual,400795,381016,19779,4.9
Nevada,1980,Annual,429584,403078,26506,6.2
Nevada,1981,Annual,463175,429828,33347,7.2
Nevada,1982,Annual,482097,434454,47643,9.9
Nevada,1983,Annual,486023,439457,46566,9.6
Nevada,1984,Annual,499664,460205,39459,7.9
Nevada,1985,Annual,516346,476503,39843,7.7
Nevada,1986,Annual,530886,498051,32835,6.2
Nevada,1987,Annual,556169,522417,33752,6.1
Nevada,1988,Annual,582023,551728,30295,5.2
Nevada,1989,Annual,604199,575600,28599,4.7
Nevada,1990,Annual,669920,638342,31578,4.7
Nevada,1991,Annual,702749,661785,40964,5.8
Nevada,1992,Annual,731906,683228,48678,6.7
Nevada,1993,Annual,768893,716242,52651,6.8
Nevada,1994,Annual,812037,761851,50186,6.2
Nevada,1995,Annual,844115,797192,46923,5.6
Nevada,1996,Annual,891348,846416,44932,5.0
Nevada,1997,Annual,939780,898496,41284,4.4
Nevada,1998,Annual,978737,937387,41350,4.2
Nevada,1999,Annual,1020300,979646,40654,4.0
Nevada,2000,Annual,1067022,1022462,44560,4.2
Nevada,2001,Annual,1112079,1054262,57817,5.2
Nevada,2002,Annual,1129668,1066121,63547,5.6
Nevada,2003,Annual,1147036,1088787,58249,5.1
Nevada,2004,Annual,1177634,1126943,50691,4.3
Nevada,2005,Annual,1223831,1173709,50122,4.1
Nevada,2006,Annual,1285318,1233287,52031,4.0
Nevada,2007,Annual,1330396,1270572,59824,4.5
Nevada,2008,Annual,1363574,1272187,91387,6.7
Nevada,2009,Annual,1349299,1196758,152541,11.3
Nevada,2010,Annual,1358578,1174774,183804,13.5
Nevada,2011,Annual,1373115,1194264,178851,13.0
Nevada,2012,Annual,1376381,1222710,153671,11.2
Nevada,2013,Annual,1381157,1248122,133035,9.6
Nevada,2014,Annual,1394758,1284292,110466,7.9
Nevada,2015,Annual,1413739,1318024,95715,6.8
Nevada,2016,Annual,1430344,1348265,82079,5.7
Nevada,2017,Annual,1462955,1389372,73583,5.0
New Hampshire,1976,Annual,397632,371686,25946,6.5
New Hampshire,1977,Annual,418365,395593,22772,5.4
New Hampshire,1978,Annual,434779,418155,16624,3.8
New Hampshire,1979,Annual,452147,437680,14467,3.2
New Hampshire,1980,Annual,466658,445531,21127,4.5
New Hampshire,1981,Annual,477481,452885,24596,5.2
New Hampshire,1982,Annual,487036,454002,33034,6.8
New Hampshire,1983,Annual,498244,470832,27412,5.5
New Hampshire,1984,Annual,520641,498275,22366,4.3
New Hampshire,1985,Annual,541015,520847,20168,3.7
New Hampshire,1986,Annual,561335,545821,15514,2.8
New Hampshire,1987,Annual,582583,569057,13526,2.3
New Hampshire,1988,Annual,599963,585505,14458,2.4
New Hampshire,1989,Annual,613360,592136,21224,3.5
New Hampshire,1990,Annual,620106,585013,35093,5.7
New Hampshire,1991,Annual,614313,569453,44860,7.3
New Hampshire,1992,Annual,614149,569430,44719,7.3
New Hampshire,1993,Annual,617488,579593,37895,6.1
New Hampshire,1994,Annual,624921,595329,29592,4.7
New Hampshire,1995,Annual,631197,606153,25044,4.0
New Hampshire,1996,Annual,638154,613822,24332,3.8
New Hampshire,1997,Annual,649244,627666,21578,3.3
New Hampshire,1998,Annual,661664,643056,18608,2.8
New Hampshire,1999,Annual,675195,656962,18233,2.7
New Hampshire,2000,Annual,687908,669621,18287,2.7
New Hampshire,2001,Annual,697760,673778,23982,3.4
New Hampshire,2002,Annual,702280,670880,31400,4.5
New Hampshire,2003,Annual,707524,677030,30494,4.3
New Hampshire,2004,Annual,716186,689150,27036,3.8
New Hampshire,2005,Annual,725849,700026,25823,3.6
New Hampshire,2006,Annual,731854,706777,25077,3.4
New Hampshire,2007,Annual,737942,712008,25934,3.5
New Hampshire,2008,Annual,742781,714104,28677,3.9
New Hampshire,2009,Annual,744227,697802,46425,6.2
New Hampshire,2010,Annual,738257,695135,43122,5.8
New Hampshire,2011,Annual,736302,696532,39770,5.4
New Hampshire,2012,Annual,741097,700371,40726,5.5
New Hampshire,2013,Annual,741285,703534,37751,5.1
New Hampshire,2014,Annual,740667,708977,31690,4.3
New Hampshire,2015,Annual,741937,716874,25063,3.4
New Hampshire,2016,Annual,746452,725154,21298,2.9
New Hampshire,2017,Annual,746549,726607,19942,2.7
New Jersey,1976,Annual,3308854,2964485,344369,10.4
New Jersey,1977,Annual,3383863,3067115,316748,9.4
New Jersey,1978,Annual,3467250,3215693,251557,7.3
New Jersey,1979,Annual,3572955,3325521,247434,6.9
New Jersey,1980,Annual,3591520,3333840,257680,7.2
New Jersey,1981,Annual,3605102,3337050,268052,7.4
New Jersey,1982,Annual,3626746,3309981,316765,8.7
New Jersey,1983,Annual,3688776,3392898,295878,8.0
New Jersey,1984,Annual,3810874,3574967,235907,6.2
New Jersey,1985,Annual,3844017,3627926,216091,5.6
New Jersey,1986,Annual,3903528,3707802,195726,5.0
New Jersey,1987,Annual,3961873,3799670,162203,4.1
New Jersey,1988,Annual,3974034,3822310,151724,3.8
New Jersey,1989,Annual,3996223,3832534,163689,4.1
New Jersey,1990,Annual,4055456,3850728,204728,5.0
New Jersey,1991,Annual,4065824,3793819,272005,6.7
New Jersey,1992,Annual,4063907,3723909,339998,8.4
New Jersey,1993,Annual,4019377,3713835,305542,7.6
New Jersey,1994,Annual,4058732,3782009,276723,6.8
New Jersey,1995,Annual,4121562,3857473,264089,6.4
New Jersey,1996,Annual,4205216,3946654,258562,6.1
New Jersey,1997,Annual,4263767,4039773,223994,5.3
New Jersey,1998,Annual,4246417,4051531,194886,4.6
New Jersey,1999,Annual,4287886,4094559,193327,4.5
New Jersey,2000,Annual,4282069,4123717,158352,3.7
New Jersey,2001,Annual,4288826,4106225,182601,4.3
New Jersey,2002,Annual,4346237,4095174,251063,5.8
New Jersey,2003,Annual,4347154,4093686,253468,5.8
New Jersey,2004,Annual,4349171,4138830,210341,4.8
New Jersey,2005,Annual,4391579,4194895,196684,4.5
New Jersey,2006,Annual,4445879,4236485,209394,4.7
New Jersey,2007,Annual,4441797,4251815,189982,4.3
New Jersey,2008,Annual,4504432,4263965,240467,5.3
New Jersey,2009,Annual,4550645,4138570,412075,9.1
New Jersey,2010,Annual,4555330,4121455,433875,9.5
New Jersey,2011,Annual,4565272,4138464,426808,9.3
New Jersey,2012,Annual,4588033,4159986,428047,9.3
New Jersey,2013,Annual,4548560,4173828,374732,8.2
New Jersey,2014,Annual,4527181,4221267,305914,6.8
New Jersey,2015,Annual,4537232,4274695,262537,5.8
New Jersey,2016,Annual,4530784,4305516,225268,5.0
New Jersey,2017,Annual,4518832,4309706,209126,4.6
New Mexico,1976,Annual,482382,439658,42724,8.9
New Mexico,1977,Annual,513455,474289,39166,7.6
New Mexico,1978,Annual,538014,506075,31939,5.9
New Mexico,1979,Annual,556087,520572,35515,6.4
New Mexico,1980,Annual,566057,523176,42881,7.6
New Mexico,1981,Annual,578162,536024,42138,7.3
New Mexico,1982,Annual,595252,540397,54855,9.2
New Mexico,1983,Annual,608731,549893,58838,9.7
New Mexico,1984,Annual,625064,576181,48883,7.8
New Mexico,1985,Annual,649722,595598,54124,8.3
New Mexico,1986,Annual,671408,608831,62577,9.3
New Mexico,1987,Annual,675614,616772,58842,8.7
New Mexico,1988,Annual,685612,634340,51272,7.5
New Mexico,1989,Annual,696460,649729,46731,6.7
New Mexico,1990,Annual,713787,666908,46879,6.6
New Mexico,1991,Annual,725155,673403,51752,7.1
New Mexico,1992,Annual,741883,688598,53285,7.2
New Mexico,1993,Annual,758589,705726,52863,7.0
New Mexico,1994,Annual,781343,730712,50631,6.5
New Mexico,1995,Annual,799191,746645,52546,6.6
New Mexico,1996,Annual,812619,754003,58616,7.2
New Mexico,1997,Annual,823101,771069,52032,6.3
New Mexico,1998,Annual,834554,783831,50723,6.1
New Mexico,1999,Annual,836237,789677,46560,5.6
New Mexico,2000,Annual,845755,804103,41652,4.9
New Mexico,2001,Annual,857949,815642,42307,4.9
New Mexico,2002,Annual,874496,826086,48410,5.5
New Mexico,2003,Annual,889730,837667,52063,5.9
New Mexico,2004,Annual,902265,852612,49653,5.5
New Mexico,2005,Annual,918156,871248,46908,5.1
New Mexico,2006,Annual,928094,889448,38646,4.2
New Mexico,2007,Annual,934027,898998,35029,3.8
New Mexico,2008,Annual,944548,902411,42137,4.5
New Mexico,2009,Annual,940352,869491,70861,7.5
New Mexico,2010,Annual,936088,860154,75934,8.1
New Mexico,2011,Annual,930356,860305,70051,7.5
New Mexico,2012,Annual,927795,861617,66178,7.1
New Mexico,2013,Annual,923899,859804,64095,6.9
New Mexico,2014,Annual,927142,865229,61913,6.7
New Mexico,2015,Annual,927999,867387,60612,6.5
New Mexico,2016,Annual,928732,866704,62028,6.7
New Mexico,2017,Annual,929567,872382,57185,6.2
New York,1976,Annual,7692561,6905369,787192,10.2
New York,1977,Annual,7731387,7024769,706618,9.1
New York,1978,Annual,7847918,7239599,608319,7.8
New York,1979,Annual,7997062,7424194,572868,7.2
New York,1980,Annual,7974354,7378756,595598,7.5
New York,1981,Annual,8022783,7412890,609893,7.6
New York,1982,Annual,7978964,7303295,675669,8.5
New York,1983,Annual,8037315,7340372,696943,8.7
New York,1984,Annual,8104569,7523862,580707,7.2
New York,1985,Annual,8293107,7744513,548594,6.6
New York,1986,Annual,8438633,7913640,524993,6.2
New York,1987,Annual,8482355,8067764,414591,4.9
New York,1988,Annual,8546476,8181123,365353,4.3
New York,1989,Annual,8698808,8265201,433607,5.0
New York,1990,Annual,8813271,8343353,469918,5.3
New York,1991,Annual,8741100,8108261,632839,7.2
New York,1992,Annual,8751234,7997602,753632,8.6
New York,1993,Annual,8715592,8026518,689074,7.9
New York,1994,Annual,8678491,8075912,602579,6.9
New York,1995,Annual,8661116,8112684,548432,6.3
New York,1996,Annual,8785710,8237123,548587,6.2
New York,1997,Annual,9012217,8432577,579640,6.4
New York,1998,Annual,9071814,8562174,509640,5.6
New York,1999,Annual,9126567,8654586,471981,5.2
New York,2000,Annual,9133869,8718749,415120,4.5
New York,2001,Annual,9151745,8709897,441848,4.8
New York,2002,Annual,9275515,8705352,570163,6.1
New York,2003,Annual,9263401,8672909,590492,6.4
New York,2004,Annual,9355953,8812618,543335,5.8
New York,2005,Annual,9460866,8986859,474007,5.0
New York,2006,Annual,9508149,9077529,430620,4.5
New York,2007,Annual,9522056,9088207,433849,4.6
New York,2008,Annual,9664773,9139080,525693,5.4
New York,2009,Annual,9647485,8844486,802999,8.3
New York,2010,Annual,9595362,8769723,825639,8.6
New York,2011,Annual,9517361,8728057,789304,8.3
New York,2012,Annual,9612232,8793385,818847,8.5
New York,2013,Annual,9659170,8913788,745382,7.7
New York,2014,Annual,9591309,8984074,607235,6.3
New York,2015,Annual,9644615,9136151,508464,5.3
New York,2016,Annual,9668687,9200266,468421,4.8
New York,2017,Annual,9704695,9249225,455470,4.7
North Carolina,1976,Annual,2609782,2446387,163395,6.3
North Carolina,1977,Annual,2688807,2530209,158598,5.9
North Carolina,1978,Annual,2764219,2640447,123772,4.5
North Carolina,1979,Annual,2810807,2677112,133695,4.8
North Carolina,1980,Annual,2853983,2671472,182511,6.4
North Carolina,1981,Annual,2911968,2722639,189329,6.5
North Carolina,1982,Annual,2935666,2665668,269998,9.2
North Carolina,1983,Annual,2945353,2681016,264337,9.0
North Carolina,1984,Annual,3029867,2826036,203831,6.7
North Carolina,1985,Annual,3106764,2933817,172947,5.6
North Carolina,1986,Annual,3185480,3017057,168423,5.3
North Carolina,1987,Annual,3266960,3118856,148104,4.5
North Carolina,1988,Annual,3320376,3199310,121066,3.6
North Carolina,1989,Annual,3396102,3276667,119435,3.5
North Carolina,1990,Annual,3476500,3333977,142523,4.1
North Carolina,1991,Annual,3538010,3333518,204492,5.8
North Carolina,1992,Annual,3603937,3386088,217849,6.0
North Carolina,1993,Annual,3628362,3446119,182243,5.0
North Carolina,1994,Annual,3686337,3524897,161440,4.4
North Carolina,1995,Annual,3763539,3601621,161918,4.3
North Carolina,1996,Annual,3901251,3733519,167732,4.3
North Carolina,1997,Annual,3983679,3834296,149383,3.7
North Carolina,1998,Annual,3990054,3851970,138084,3.5
North Carolina,1999,Annual,4057006,3927179,129827,3.2
North Carolina,2000,Annual,4138190,3986151,152039,3.7
North Carolina,2001,Annual,4198338,3966798,231540,5.5
North Carolina,2002,Annual,4184713,3906570,278143,6.6
North Carolina,2003,Annual,4255631,3984596,271035,6.4
North Carolina,2004,Annual,4253126,4019809,233317,5.5
North Carolina,2005,Annual,4317428,4091039,226389,5.2
North Carolina,2006,Annual,4444967,4234095,210872,4.7
North Carolina,2007,Annual,4512856,4300304,212552,4.7
North Carolina,2008,Annual,4560059,4281713,278346,6.1
North Carolina,2009,Annual,4570789,4087105,483684,10.6
North Carolina,2010,Annual,4616691,4115629,501062,10.9
North Carolina,2011,Annual,4633072,4157543,475529,10.3
North Carolina,2012,Annual,4680057,4245675,434382,9.3
North Carolina,2013,Annual,4692940,4318114,374826,8.0
North Carolina,2014,Annual,4699058,4402450,296608,6.3
North Carolina,2015,Annual,4768806,4495190,273616,5.7
North Carolina,2016,Annual,4854828,4608229,246599,5.1
North Carolina,2017,Annual,4941701,4716832,224869,4.6
North Dakota,1976,Annual,278686,268394,10292,3.7
North Dakota,1977,Annual,287162,274115,13047,4.5
North Dakota,1978,Annual,293863,281366,12497,4.3
North Dakota,1979,Annual,299850,287826,12024,4.0
North Dakota,1980,Annual,303355,288400,14955,4.9
North Dakota,1981,Annual,309566,294628,14938,4.8
North Dakota,1982,Annual,315885,298343,17542,5.6
North Dakota,1983,Annual,320240,302120,18120,5.7
North Dakota,1984,Annual,326772,309531,17241,5.3
North Dakota,1985,Annual,332622,313695,18927,5.7
North Dakota,1986,Annual,332507,313041,19466,5.9
North Dakota,1987,Annual,330954,314330,16624,5.0
North Dakota,1988,Annual,330983,315478,15505,4.7
North Dakota,1989,Annual,330463,316267,14196,4.3
North Dakota,1990,Annual,317217,304436,12781,4.0
North Dakota,1991,Annual,315214,301479,13735,4.4
North Dakota,1992,Annual,315924,300939,14985,4.7
North Dakota,1993,Annual,323927,310061,13866,4.3
North Dakota,1994,Annual,336807,324314,12493,3.7
North Dakota,1995,Annual,340299,329348,10951,3.2
North Dakota,1996,Annual,347537,337412,10125,2.9
North Dakota,1997,Annual,351391,341823,9568,2.7
North Dakota,1998,Annual,349505,339414,10091,2.9
North Dakota,1999,Annual,343452,332180,11272,3.3
North Dakota,2000,Annual,342568,332407,10161,3.0
North Dakota,2001,Annual,341816,331820,9996,2.9
North Dakota,2002,Annual,340631,327957,12674,3.7
North Dakota,2003,Annual,344676,331852,12824,3.7
North Dakota,2004,Annual,352466,340403,12063,3.4
North Dakota,2005,Annual,355545,343508,12037,3.4
North Dakota,2006,Annual,361459,349821,11638,3.2
North Dakota,2007,Annual,367234,355766,11468,3.1
North Dakota,2008,Annual,371025,359333,11692,3.2
North Dakota,2009,Annual,368665,353455,15210,4.1
North Dakota,2010,Annual,378342,364053,14289,3.8
North Dakota,2011,Annual,388634,375153,13481,3.5
North Dakota,2012,Annual,397867,385674,12193,3.1
North Dakota,2013,Annual,406193,394392,11801,2.9
North Dakota,2014,Annual,414413,403362,11051,2.7
North Dakota,2015,Annual,414210,402667,11543,2.8
North Dakota,2016,Annual,414431,401671,12760,3.1
North Dakota,2017,Annual,414399,403610,10789,2.6
Ohio,1976,Annual,4755748,4385605,370143,7.8
Ohio,1977,Annual,4833856,4517698,316158,6.5
Ohio,1978,Annual,4950642,4680243,270399,5.5
Ohio,1979,Annual,5055136,4759906,295230,5.8
Ohio,1980,Annual,5087387,4662318,425069,8.4
Ohio,1981,Annual,5105836,4624361,481475,9.4
Ohio,1982,Annual,5126857,4475830,651027,12.7
Ohio,1983,Annual,5097422,4467277,630145,12.4
Ohio,1984,Annual,5096523,4614643,481880,9.5
Ohio,1985,Annual,5153700,4694344,459356,8.9
Ohio,1986,Annual,5222904,4791014,431890,8.3
Ohio,1987,Annual,5259505,4887075,372430,7.1
Ohio,1988,Annual,5317556,4996315,321241,6.0
Ohio,1989,Annual,5380101,5081552,298549,5.5
Ohio,1990,Annual,5419623,5114242,305381,5.6
Ohio,1991,Annual,5431912,5080289,351623,6.5
Ohio,1992,Annual,5503260,5097104,406156,7.4
Ohio,1993,Annual,5501305,5136613,364692,6.6
Ohio,1994,Annual,5548818,5239265,309553,5.6
Ohio,1995,Annual,5589102,5320351,268751,4.8
Ohio,1996,Annual,5645423,5362986,282437,5.0
Ohio,1997,Annual,5695177,5431051,264126,4.6
Ohio,1998,Annual,5707110,5460917,246193,4.3
Ohio,1999,Annual,5754992,5508439,246553,4.3
Ohio,2000,Annual,5787343,5556757,230586,4.0
Ohio,2001,Annual,5816832,5567130,249702,4.3
Ohio,2002,Annual,5852985,5516645,336340,5.7
Ohio,2003,Annual,5872372,5505858,366514,6.2
Ohio,2004,Annual,5870479,5502444,368035,6.3
Ohio,2005,Annual,5890046,5541082,348964,5.9
Ohio,2006,Annual,5945482,5624435,321047,5.4
Ohio,2007,Annual,5990292,5657718,332574,5.6
Ohio,2008,Annual,5965166,5580843,384323,6.4
Ohio,2009,Annual,5906768,5297098,609670,10.3
Ohio,2010,Annual,5846886,5247050,599836,10.3
Ohio,2011,Annual,5771469,5261238,510231,8.8
Ohio,2012,Annual,5705591,5284001,421590,7.4
Ohio,2013,Annual,5716730,5290609,426121,7.5
Ohio,2014,Annual,5701477,5370560,330917,5.8
Ohio,2015,Annual,5694303,5414872,279431,4.9
Ohio,2016,Annual,5739296,5451315,287981,5.0
Ohio,2017,Annual,5780021,5491174,288847,5.0
Oklahoma,1976,Annual,1187330,1119538,67792,5.7
Oklahoma,1977,Annual,1234371,1173543,60828,4.9
Oklahoma,1978,Annual,1270542,1224682,45860,3.6
Oklahoma,1979,Annual,1311532,1267053,44479,3.4
Oklahoma,1980,Annual,1370727,1310022,60705,4.4
Oklahoma,1981,Annual,1438610,1386295,52315,3.6
Oklahoma,1982,Annual,1494118,1404210,89908,6.0
Oklahoma,1983,Annual,1541193,1412250,128943,8.4
Oklahoma,1984,Annual,1559584,1449534,110050,7.1
Oklahoma,1985,Annual,1567481,1454530,112951,7.2
Oklahoma,1986,Annual,1590593,1459542,131051,8.2
Oklahoma,1987,Annual,1558956,1445778,113178,7.3
Oklahoma,1988,Annual,1527352,1429172,98180,6.4
Oklahoma,1989,Annual,1519275,1433589,85686,5.6
Oklahoma,1990,Annual,1523545,1436914,86631,5.7
Oklahoma,1991,Annual,1507357,1412364,94993,6.3
Oklahoma,1992,Annual,1517081,1425792,91289,6.0
Oklahoma,1993,Annual,1533187,1442202,90985,5.9
Oklahoma,1994,Annual,1548909,1462579,86330,5.6
Oklahoma,1995,Annual,1555736,1484470,71266,4.6
Oklahoma,1996,Annual,1580955,1516423,64532,4.1
Oklahoma,1997,Annual,1609954,1544175,65779,4.1
Oklahoma,1998,Annual,1637452,1567803,69649,4.3
Oklahoma,1999,Annual,1656205,1597894,58311,3.5
Oklahoma,2000,Annual,1660528,1610099,50429,3.0
Oklahoma,2001,Annual,1675935,1614572,61363,3.7
Oklahoma,2002,Annual,1686568,1608106,78462,4.7
Oklahoma,2003,Annual,1685572,1593521,92051,5.5
Oklahoma,2004,Annual,1689608,1607421,82187,4.9
Oklahoma,2005,Annual,1703293,1627110,76183,4.5
Oklahoma,2006,Annual,1715794,1647098,68696,4.0
Oklahoma,2007,Annual,1726259,1655490,70769,4.1
Oklahoma,2008,Annual,1746466,1681081,65385,3.7
Oklahoma,2009,Annual,1764432,1652023,112409,6.4
Oklahoma,2010,Annual,1768284,1648138,120146,6.8
Oklahoma,2011,Annual,1772666,1668418,104248,5.9
Oklahoma,2012,Annual,1803863,1709258,94605,5.2
Oklahoma,2013,Annual,1802073,1706861,95212,5.3
Oklahoma,2014,Annual,1796183,1715600,80583,4.5
Oklahoma,2015,Annual,1830358,1749626,80732,4.4
Oklahoma,2016,Annual,1829413,1741277,88136,4.8
Oklahoma,2017,Annual,1834312,1755604,78708,4.3
Oregon,1976,Annual,1090242,988076,102166,9.4
Oregon,1977,Annual,1156384,1070417,85967,7.4
Oregon,1978,Annual,1216053,1142543,73510,6.0
Oregon,1979,Annual,1253483,1169599,83884,6.7
Oregon,1980,Annual,1298181,1188148,110033,8.5
Oregon,1981,Annual,1332668,1202242,130426,9.8
Oregon,1982,Annual,1329233,1175780,153453,11.5
Oregon,1983,Annual,1334345,1190294,144051,10.8
Oregon,1984,Annual,1328665,1203487,125178,9.4
Oregon,1985,Annual,1321878,1205144,116734,8.8
Oregon,1986,Annual,1356675,1247520,109155,8.0
Oregon,1987,Annual,1390525,1303454,87071,6.3
Oregon,1988,Annual,1430852,1348376,82476,5.8
Oregon,1989,Annual,1466406,1386726,79680,5.4
Oregon,1990,Annual,1490722,1408687,82035,5.5
Oregon,1991,Annual,1516876,1420124,96752,6.4
Oregon,1992,Annual,1554604,1439531,115073,7.4
Oregon,1993,Annual,1599829,1487375,112454,7.0
Oregon,1994,Annual,1646846,1557373,89473,5.4
Oregon,1995,Annual,1672690,1590664,82026,4.9
Oregon,1996,Annual,1719625,1621602,98023,5.7
Oregon,1997,Annual,1750280,1651241,99039,5.7
Oregon,1998,Annual,1779976,1677740,102236,5.7
Oregon,1999,Annual,1793699,1694881,98818,5.5
Oregon,2000,Annual,1818559,1725744,92815,5.1
Oregon,2001,Annual,1823916,1706904,117012,6.4
Oregon,2002,Annual,1835325,1697237,138088,7.5
Oregon,2003,Annual,1845544,1695906,149638,8.1
Oregon,2004,Annual,1838112,1703703,134409,7.3
Oregon,2005,Annual,1845761,1731845,113916,6.2
Oregon,2006,Annual,1885385,1785044,100341,5.3
Oregon,2007,Annual,1921766,1822772,98994,5.2
Oregon,2008,Annual,1955121,1827352,127769,6.5
Oregon,2009,Annual,1976638,1753682,222956,11.3
Oregon,2010,Annual,1984039,1773076,210963,10.6
Oregon,2011,Annual,1993889,1804320,189569,9.5
Oregon,2012,Annual,1953439,1780790,172649,8.8
Oregon,2013,Annual,1910702,1760302,150400,7.9
Oregon,2014,Annual,1935884,1804417,131467,6.8
Oregon,2015,Annual,1978226,1867407,110819,5.6
Oregon,2016,Annual,2049480,1951218,98262,4.8
Oregon,2017,Annual,2104078,2017292,86786,4.1
Pennsylvania,1976,Annual,5125768,4717649,408119,8.0
Pennsylvania,1977,Annual,5204966,4805846,399120,7.7
Pennsylvania,1978,Annual,5304589,4936671,367918,6.9
Pennsylvania,1979,Annual,5384412,5015577,368835,6.9
Pennsylvania,1980,Annual,5435928,4999664,436264,8.0
Pennsylvania,1981,Annual,5478375,5019066,459309,8.4
Pennsylvania,1982,Annual,5492370,4879737,612633,11.2
Pennsylvania,1983,Annual,5480516,4849850,630666,11.5
Pennsylvania,1984,Annual,5495136,4996147,498989,9.1
Pennsylvania,1985,Annual,5552886,5108212,444674,8.0
Pennsylvania,1986,Annual,5603120,5216732,386388,6.9
Pennsylvania,1987,Annual,5662027,5342251,319776,5.6
Pennsylvania,1988,Annual,5762223,5471632,290591,5.0
Pennsylvania,1989,Annual,5826436,5553128,273308,4.7
Pennsylvania,1990,Annual,5828450,5510435,318015,5.5
Pennsylvania,1991,Annual,5855127,5442516,412611,7.0
Pennsylvania,1992,Annual,5911157,5462170,448987,7.6
Pennsylvania,1993,Annual,5904299,5491547,412752,7.0
Pennsylvania,1994,Annual,5893118,5523612,369506,6.3
Pennsylvania,1995,Annual,5908490,5562508,345982,5.9
Pennsylvania,1996,Annual,5979581,5653830,325751,5.4
Pennsylvania,1997,Annual,6056001,5746071,309930,5.1
Pennsylvania,1998,Annual,6063130,5783197,279933,4.6
Pennsylvania,1999,Annual,6076778,5810162,266616,4.4
Pennsylvania,2000,Annual,6106892,5854551,252341,4.1
Pennsylvania,2001,Annual,6178617,5881688,296929,4.8
Pennsylvania,2002,Annual,6218643,5868607,350036,5.6
Pennsylvania,2003,Annual,6170359,5821711,348648,5.7
Pennsylvania,2004,Annual,6213778,5876997,336781,5.4
Pennsylvania,2005,Annual,6251402,5940570,310832,5.0
Pennsylvania,2006,Annual,6294504,6006634,287870,4.6
Pennsylvania,2007,Annual,6342997,6064063,278934,4.4
Pennsylvania,2008,Annual,6451535,6109645,341890,5.3
Pennsylvania,2009,Annual,6400263,5885351,514912,8.0
Pennsylvania,2010,Annual,6380949,5840887,540062,8.5
Pennsylvania,2011,Annual,6395506,5888745,506761,7.9
Pennsylvania,2012,Annual,6462939,5957314,505625,7.8
Pennsylvania,2013,Annual,6442411,5967811,474600,7.4
Pennsylvania,2014,Annual,6396041,6021005,375036,5.9
Pennsylvania,2015,Annual,6420702,6080219,340483,5.3
Pennsylvania,2016,Annual,6452812,6105223,347589,5.4
Pennsylvania,2017,Annual,6427370,6111633,315737,4.9
Rhode Island,1976,Annual,436975,401034,35941,8.2
Rhode Island,1977,Annual,446289,410459,35830,8.0
Rhode Island,1978,Annual,450847,421292,29555,6.6
Rhode Island,1979,Annual,460738,431224,29514,6.4
Rhode Island,1980,Annual,468996,435133,33863,7.2
Rhode Island,1981,Annual,475921,438978,36943,7.8
Rhode Island,1982,Annual,475945,429805,46140,9.7
Rhode Island,1983,Annual,476842,437276,39566,8.3
Rhode Island,1984,Annual,487592,460735,26857,5.5
Rhode Island,1985,Annual,499236,476104,23132,4.6
Rhode Island,1986,Annual,509201,488500,20701,4.1
Rhode Island,1987,Annual,516940,498292,18648,3.6
Rhode Island,1988,Annual,521583,505369,16214,3.1
Rhode Island,1989,Annual,524842,503207,21635,4.1
Rhode Island,1990,Annual,525361,492002,33359,6.3
Rhode Island,1991,Annual,518015,473648,44367,8.6
Rhode Island,1992,Annual,526655,479904,46751,8.9
Rhode Island,1993,Annual,522244,481774,40470,7.7
Rhode Island,1994,Annual,514025,478567,35458,6.9
Rhode Island,1995,Annual,511418,479080,32338,6.3
Rhode Island,1996,Annual,516096,488009,28087,5.4
Rhode Island,1997,Annual,527878,500704,27174,5.1
Rhode Island,1998,Annual,532609,508064,24545,4.6
Rhode Island,1999,Annual,538096,515760,22336,4.2
Rhode Island,2000,Annual,543561,521313,22248,4.1
Rhode Island,2001,Annual,543862,519044,24818,4.6
Rhode Island,2002,Annual,550256,522832,27424,5.0
Rhode Island,2003,Annual,560483,530567,29916,5.3
Rhode Island,2004,Annual,558688,529893,28795,5.2
Rhode Island,2005,Annual,565735,537194,28541,5.0
Rhode Island,2006,Annual,572601,544357,28244,4.9
Rhode Island,2007,Annual,573173,543401,29772,5.2
Rhode Island,2008,Annual,570328,525941,44387,7.8
Rhode Island,2009,Annual,567280,504951,62329,11.0
Rhode Island,2010,Annual,566704,503216,63488,11.2
Rhode Island,2011,Annual,560056,498248,61808,11.0
Rhode Island,2012,Annual,558487,500434,58053,10.4
Rhode Island,2013,Annual,556926,505370,51556,9.3
Rhode Island,2014,Annual,555909,513121,42788,7.7
Rhode Island,2015,Annual,554486,521255,33231,6.0
Rhode Island,2016,Annual,553555,524745,28810,5.2
Rhode Island,2017,Annual,554658,529867,24791,4.5
South Carolina,1976,Annual,1296233,1202671,93562,7.2
South Carolina,1977,Annual,1326618,1235507,91111,6.9
South Carolina,1978,Annual,1353561,1276011,77550,5.7
South Carolina,1979,Annual,1371335,1302453,68882,5.0
South Carolina,1980,Annual,1404592,1309817,94775,6.7
South Carolina,1981,Annual,1440956,1323937,117019,8.1
South Carolina,1982,Annual,1478368,1314318,164050,11.1
South Carolina,1983,Annual,1484428,1338068,146360,9.9
South Carolina,1984,Annual,1504924,1401036,103888,6.9
South Carolina,1985,Annual,1547943,1440832,107111,6.9
South Carolina,1986,Annual,1587452,1485545,101907,6.4
South Carolina,1987,Annual,1624528,1534652,89876,5.5
South Carolina,1988,Annual,1656972,1579756,77216,4.7
South Carolina,1989,Annual,1697915,1619360,78555,4.6
South Carolina,1990,Annual,1743547,1659997,83550,4.8
South Carolina,1991,Annual,1758778,1650987,107791,6.1
South Carolina,1992,Annual,1789261,1668893,120368,6.7
South Carolina,1993,Annual,1829683,1696624,133059,7.3
South Carolina,1994,Annual,1843154,1728300,114854,6.2
South Carolina,1995,Annual,1857227,1760567,96660,5.2
South Carolina,1996,Annual,1893455,1783783,109672,5.8
South Carolina,1997,Annual,1911635,1824147,87488,4.6
South Carolina,1998,Annual,1941200,1867808,73392,3.8
South Carolina,1999,Annual,1981546,1897056,84490,4.3
South Carolina,2000,Annual,1993562,1918583,74979,3.8
South Carolina,2001,Annual,1949685,1847939,101746,5.2
South Carolina,2002,Annual,1949135,1835823,113312,5.8
South Carolina,2003,Annual,1997977,1859765,138212,6.9
South Carolina,2004,Annual,2033310,1894141,139169,6.8
South Carolina,2005,Annual,2068599,1929233,139366,6.7
South Carolina,2006,Annual,2109097,1973337,135760,6.4
South Carolina,2007,Annual,2125891,2005686,120205,5.7
South Carolina,2008,Annual,2142232,1996409,145823,6.8
South Carolina,2009,Annual,2152745,1910670,242075,11.2
South Carolina,2010,Annual,2155668,1915045,240623,11.2
South Carolina,2011,Annual,2175523,1945900,229623,10.6
South Carolina,2012,Annual,2186878,1985618,201260,9.2
South Carolina,2013,Annual,2190968,2023642,167326,7.6
South Carolina,2014,Annual,2222978,2079565,143413,6.5
South Carolina,2015,Annual,2269339,2134244,135095,6.0
South Carolina,2016,Annual,2293666,2179521,114145,5.0
South Carolina,2017,Annual,2312651,2213894,98757,4.3
South Dakota,1976,Annual,309906,299820,10086,3.3
South Dakota,1977,Annual,317559,307134,10425,3.3
South Dakota,1978,Annual,326810,316733,10077,3.1
South Dakota,1979,Annual,332946,321745,11201,3.4
South Dakota,1980,Annual,335049,318952,16097,4.8
South Dakota,1981,Annual,334385,317807,16578,5.0
South Dakota,1982,Annual,331818,313682,18136,5.5
South Dakota,1983,Annual,334537,317084,17453,5.2
South Dakota,1984,Annual,341952,326984,14968,4.4
South Dakota,1985,Annual,345294,328562,16732,4.8
South Dakota,1986,Annual,348925,332959,15966,4.6
South Dakota,1987,Annual,353333,338464,14869,4.2
South Dakota,1988,Annual,357415,342741,14674,4.1
South Dakota,1989,Annual,360925,346463,14462,4.0
South Dakota,1990,Annual,347178,334087,13091,3.8
South Dakota,1991,Annual,350013,337762,12251,3.5
South Dakota,1992,Annual,356762,344908,11854,3.3
South Dakota,1993,Annual,365476,353208,12268,3.4
South Dakota,1994,Annual,378141,365796,12345,3.3
South Dakota,1995,Annual,387360,375564,11796,3.0
South Dakota,1996,Annual,391213,378883,12330,3.2
South Dakota,1997,Annual,393649,382116,11533,2.9
South Dakota,1998,Annual,399442,388291,11151,2.8
South Dakota,1999,Annual,406105,395047,11058,2.7
South Dakota,2000,Annual,408658,398618,10040,2.5
South Dakota,2001,Annual,412778,400031,12747,3.1
South Dakota,2002,Annual,417517,404239,13278,3.2
South Dakota,2003,Annual,423035,408088,14947,3.5
South Dakota,2004,Annual,427664,411762,15902,3.7
South Dakota,2005,Annual,430606,414209,16397,3.8
South Dakota,2006,Annual,435007,421483,13524,3.1
South Dakota,2007,Annual,442499,430011,12488,2.8
South Dakota,2008,Annual,446618,432925,13693,3.1
South Dakota,2009,Annual,446010,423993,22017,4.9
South Dakota,2010,Annual,441339,419355,21984,5.0
South Dakota,2011,Annual,440934,420054,20880,4.7
South Dakota,2012,Annual,442442,423501,18941,4.3
South Dakota,2013,Annual,443079,426284,16795,3.8
South Dakota,2014,Annual,446475,431139,15336,3.4
South Dakota,2015,Annual,449408,435450,13958,3.1
South Dakota,2016,Annual,451934,438377,13557,3.0
South Dakota,2017,Annual,455175,440028,15147,3.3
Tennessee,1976,Annual,1856518,1743474,113044,6.1
Tennessee,1977,Annual,1939384,1818232,121152,6.2
Tennessee,1978,Annual,1977234,1862038,115196,5.8
Tennessee,1979,Annual,2043202,1923863,119339,5.8
Tennessee,1980,Annual,2081202,1926451,154751,7.4
Tennessee,1981,Annual,2109072,1920257,188815,9.0
Tennessee,1982,Annual,2132868,1882724,250144,11.7
Tennessee,1983,Annual,2179996,1928527,251469,11.5
Tennessee,1984,Annual,2224347,2034185,190162,8.5
Tennessee,1985,Annual,2257243,2077808,179435,7.9
Tennessee,1986,Annual,2300145,2118432,181713,7.9
Tennessee,1987,Annual,2334831,2180696,154135,6.6
Tennessee,1988,Annual,2345200,2208637,136563,5.8
Tennessee,1989,Annual,2367338,2247161,120177,5.1
Tennessee,1990,Annual,2394729,2266764,127965,5.3
Tennessee,1991,Annual,2413716,2250608,163108,6.8
Tennessee,1992,Annual,2457179,2297364,159815,6.5
Tennessee,1993,Annual,2526887,2380485,146402,5.8
Tennessee,1994,Annual,2659938,2531129,128809,4.8
Tennessee,1995,Annual,2732184,2591472,140712,5.2
Tennessee,1996,Annual,2767002,2623757,143245,5.2
Tennessee,1997,Annual,2786082,2639198,146884,5.3
Tennessee,1998,Annual,2812390,2691517,120873,4.3
Tennessee,1999,Annual,2852445,2739189,113256,4.0
Tennessee,2000,Annual,2843069,2733281,109788,3.9
Tennessee,2001,Annual,2861343,2730988,130355,4.6
Tennessee,2002,Annual,2906591,2756086,150505,5.2
Tennessee,2003,Annual,2912187,2748140,164047,5.6
Tennessee,2004,Annual,2878736,2725108,153628,5.3
Tennessee,2005,Annual,2904794,2743383,161411,5.6
Tennessee,2006,Annual,3036029,2878455,157574,5.2
Tennessee,2007,Annual,3063669,2920352,143317,4.7
Tennessee,2008,Annual,3054785,2853746,201039,6.6
Tennessee,2009,Annual,3052678,2733113,319565,10.5
Tennessee,2010,Annual,3090795,2792063,298732,9.7
Tennessee,2011,Annual,3125307,2844662,280645,9.0
Tennessee,2012,Annual,3100671,2857945,242726,7.8
Tennessee,2013,Annual,3067431,2828479,238952,7.8
Tennessee,2014,Annual,3022927,2824016,198911,6.6
Tennessee,2015,Annual,3062706,2890640,172066,5.6
Tennessee,2016,Annual,3134725,2987074,147651,4.7
Tennessee,2017,Annual,3198767,3080210,118557,3.7
Texas,1976,Annual,5710482,5381249,329233,5.8
Texas,1977,Annual,5950809,5633267,317542,5.3
Texas,1978,Annual,6209219,5909838,299381,4.8
Texas,1979,Annual,6470105,6190525,279580,4.3
Texas,1980,Annual,6752517,6404883,347634,5.1
Texas,1981,Annual,7061470,6686969,374501,5.3
Texas,1982,Annual,7376503,6867966,508537,6.9
Texas,1983,Annual,7643814,7037893,605921,7.9
Texas,1984,Annual,7840165,7360153,480012,6.1
Texas,1985,Annual,8028508,7463323,565185,7.0
Texas,1986,Annual,8179583,7463198,716385,8.8
Texas,1987,Annual,8274343,7576650,697693,8.4
Texas,1988,Annual,8337079,7724807,612272,7.3
Texas,1989,Annual,8442930,7881265,561665,6.7
Texas,1990,Annual,8618927,8073257,545670,6.3
Texas,1991,Annual,8766240,8160512,605728,6.9
Texas,1992,Annual,9005336,8317300,688036,7.6
Texas,1993,Annual,9187561,8530187,657374,7.2
Texas,1994,Annual,9403041,8793183,609858,6.5
Texas,1995,Annual,9577635,8997538,580097,6.1
Texas,1996,Annual,9719628,9165916,553712,5.7
Texas,1997,Annual,9922250,9395537,526713,5.3
Texas,1998,Annual,10095846,9603021,492825,4.9
Texas,1999,Annual,10245857,9767851,478006,4.7
Texas,2000,Annual,10374053,9929387,444666,4.3
Texas,2001,Annual,10532732,10011046,521686,5.0
Texas,2002,Annual,10748810,10065870,682940,6.4
Texas,2003,Annual,10914664,10185312,729352,6.7
Texas,2004,Annual,10992359,10338484,653875,5.9
Texas,2005,Annual,11124240,10523257,600983,5.4
Texas,2006,Annual,11327995,10774490,553505,4.9
Texas,2007,Annual,11431631,10941413,490218,4.3
Texas,2008,Annual,11664390,11104115,560275,4.8
Texas,2009,Annual,11910799,11008903,901896,7.6
Texas,2010,Annual,12241970,11244632,997338,8.1
Texas,2011,Annual,12504498,11535095,969403,7.8
Texas,2012,Annual,12670455,11818675,851780,6.7
Texas,2013,Annual,12857595,12052646,804949,6.3
Texas,2014,Annual,13024701,12360368,664333,5.1
Texas,2015,Annual,13074570,12493197,581373,4.4
Texas,2016,Annual,13317176,12702122,615054,4.6
Texas,2017,Annual,13538385,12960595,577790,4.3
Utah,1976,Annual,527232,497703,29529,5.6
Utah,1977,Annual,545853,517830,28023,5.1
Utah,1978,Annual,567238,545669,21569,3.8
Utah,1979,Annual,604729,578533,26196,4.3
Utah,1980,Annual,629827,590777,39050,6.2
Utah,1981,Annual,647080,604666,42414,6.6
Utah,1982,Annual,673441,618270,55171,8.2
Utah,1983,Annual,688079,628089,59990,8.7
Utah,1984,Annual,704638,659064,45574,6.5
Utah,1985,Annual,730769,686628,44141,6.0
Utah,1986,Annual,750189,704533,45656,6.1
Utah,1987,Annual,755593,708540,47053,6.2
Utah,1988,Annual,761260,723514,37746,5.0
Utah,1989,Annual,789203,753358,35845,4.5
Utah,1990,Annual,822207,786073,36134,4.4
Utah,1991,Annual,852319,812206,40113,4.7
Utah,1992,Annual,888853,845770,43083,4.8
Utah,1993,Annual,940966,902780,38186,4.1
Utah,1994,Annual,990791,953282,37509,3.8
Utah,1995,Annual,1012703,977294,35409,3.5
Utah,1996,Annual,1038967,1003979,34988,3.4
Utah,1997,Annual,1070223,1036156,34067,3.2
Utah,1998,Annual,1100830,1060663,40167,3.6
Utah,1999,Annual,1120920,1081276,39644,3.5
Utah,2000,Annual,1142044,1103807,38237,3.3
Utah,2001,Annual,1164077,1112607,51470,4.4
Utah,2002,Annual,1184751,1116067,68684,5.8
Utah,2003,Annual,1200236,1132554,67682,5.6
Utah,2004,Annual,1231160,1169795,61365,5.0
Utah,2005,Annual,1272445,1220617,51828,4.1
Utah,2006,Annual,1318450,1279328,39122,3.0
Utah,2007,Annual,1359129,1324060,35069,2.6
Utah,2008,Annual,1371201,1322089,49112,3.6
Utah,2009,Annual,1365850,1266009,99841,7.3
Utah,2010,Annual,1356097,1249814,106283,7.8
Utah,2011,Annual,1350444,1259337,91107,6.7
Utah,2012,Annual,1372971,1298807,74164,5.4
Utah,2013,Annual,1405630,1341192,64438,4.6
Utah,2014,Annual,1428293,1373801,54492,3.8
Utah,2015,Annual,1464173,1411194,52979,3.6
Utah,2016,Annual,1511279,1459309,51970,3.4
Utah,2017,Annual,1560846,1510208,50638,3.2
Vermont,1976,Annual,216308,198294,18014,8.3
Vermont,1977,Annual,228284,212351,15933,7.0
Vermont,1978,Annual,239606,226182,13424,5.6
Vermont,1979,Annual,244838,232231,12607,5.1
Vermont,1980,Annual,250246,234772,15474,6.2
Vermont,1981,Annual,257581,242633,14948,5.8
Vermont,1982,Annual,263223,244873,18350,7.0
Vermont,1983,Annual,264317,247314,17003,6.4
Vermont,1984,Annual,268562,254929,13633,5.1
Vermont,1985,Annual,278950,265592,13358,4.8
Vermont,1986,Annual,288936,276583,12353,4.3
Vermont,1987,Annual,295679,285139,10540,3.6
Vermont,1988,Annual,301054,292060,8994,3.0
Vermont,1989,Annual,305936,295100,10836,3.5
Vermont,1990,Annual,304774,289509,15265,5.0
Vermont,1991,Annual,303590,283676,19914,6.6
Vermont,1992,Annual,307571,288803,18768,6.1
Vermont,1993,Annual,312578,296457,16121,5.2
Vermont,1994,Annual,315615,301185,14430,4.6
Vermont,1995,Annual,319849,306140,13709,4.3
Vermont,1996,Annual,323956,310043,13913,4.3
Vermont,1997,Annual,327878,315053,12825,3.9
Vermont,1998,Annual,333732,322398,11334,3.4
Vermont,1999,Annual,336946,326979,9967,3.0
Vermont,2000,Annual,331404,322129,9275,2.8
Vermont,2001,Annual,337065,325889,11176,3.3
Vermont,2002,Annual,343139,329427,13712,4.0
Vermont,2003,Annual,345971,331122,14849,4.3
Vermont,2004,Annual,347673,334899,12774,3.7
Vermont,2005,Annual,350766,338553,12213,3.5
Vermont,2006,Annual,357007,343865,13142,3.7
Vermont,2007,Annual,353739,339547,14192,4.0
Vermont,2008,Annual,354899,338273,16626,4.7
Vermont,2009,Annual,359836,336104,23732,6.6
Vermont,2010,Annual,359402,337488,21914,6.1
Vermont,2011,Annual,358108,338463,19645,5.5
Vermont,2012,Annual,354857,337284,17573,5.0
Vermont,2013,Annual,350447,334964,15483,4.4
Vermont,2014,Annual,347172,333438,13734,4.0
Vermont,2015,Annual,344520,332199,12321,3.6
Vermont,2016,Annual,344572,333399,11173,3.2
Vermont,2017,Annual,344760,334378,10382,3.0
Virginia,1976,Annual,2340718,2203492,137226,5.9
Virginia,1977,Annual,2406419,2275008,131411,5.5
Virginia,1978,Annual,2491973,2360420,131553,5.3
Virginia,1979,Annual,2536127,2415835,120292,4.7
Virginia,1980,Annual,2560172,2428172,132000,5.2
Virginia,1981,Annual,2607554,2450737,156817,6.0
Virginia,1982,Annual,2651253,2453767,197486,7.4
Virginia,1983,Annual,2721531,2546049,175482,6.4
Virginia,1984,Annual,2817037,2673670,143367,5.1
Virginia,1985,Annual,2862792,2705622,157170,5.5
Virginia,1986,Annual,2913661,2767014,146647,5.0
Virginia,1987,Annual,3004002,2875916,128086,4.3
Virginia,1988,Annual,3082007,2960606,121401,3.9
Virginia,1989,Annual,3151756,3029456,122300,3.9
Virginia,1990,Annual,3252176,3107094,145082,4.5
Virginia,1991,Annual,3339309,3142207,197102,5.9
Virginia,1992,Annual,3400299,3186823,213476,6.3
Virginia,1993,Annual,3378790,3201717,177073,5.2
Virginia,1994,Annual,3428901,3262236,166665,4.9
Virginia,1995,Annual,3451089,3295134,155955,4.5
Virginia,1996,Annual,3420680,3268553,152127,4.4
Virginia,1997,Annual,3446323,3314344,131979,3.8
Virginia,1998,Annual,3485097,3383752,101345,2.9
Virginia,1999,Annual,3540081,3443020,97061,2.7
Virginia,2000,Annual,3605811,3522865,82946,2.3
Virginia,2001,Annual,3670137,3551375,118762,3.2
Virginia,2002,Annual,3726468,3569570,156898,4.2
Virginia,2003,Annual,3753703,3599264,154439,4.1
Virginia,2004,Annual,3795246,3650269,144977,3.8
Virginia,2005,Annual,3897042,3757592,139450,3.6
Virginia,2006,Annual,3978641,3855633,123008,3.1
Virginia,2007,Annual,4036835,3914087,122748,3.0
Virginia,2008,Annual,4133443,3970428,163015,3.9
Virginia,2009,Annual,4118171,3842516,275655,6.7
Virginia,2010,Annual,4157658,3860386,297272,7.1
Virginia,2011,Annual,4211802,3934326,277476,6.6
Virginia,2012,Annual,4223844,3967987,255857,6.1
Virginia,2013,Annual,4237277,3995182,242095,5.7
Virginia,2014,Annual,4244109,4022160,221949,5.2
Virginia,2015,Annual,4216974,4029043,187931,4.5
Virginia,2016,Annual,4242650,4069139,173511,4.1
Virginia,2017,Annual,4307753,4146134,161619,3.8
Washington,1976,Annual,1618814,1474876,143938,8.9
Washington,1977,Annual,1696825,1553328,143497,8.5
Washington,1978,Annual,1809342,1685368,123974,6.9
Washington,1979,Annual,1930439,1802077,128362,6.6
Washington,1980,Annual,1984675,1823883,160792,8.1
Washington,1981,Annual,1997449,1806668,190781,9.6
Washington,1982,Annual,2023476,1781699,241777,11.9
Washington,1983,Annual,2056817,1828724,228093,11.1
Washington,1984,Annual,2064244,1872645,191599,9.3
Washington,1985,Annual,2097674,1922407,175267,8.4
Washington,1986,Annual,2188078,2010442,177636,8.1
Washington,1987,Annual,2257364,2091788,165576,7.3
Washington,1988,Annual,2326789,2180097,146692,6.3
Washington,1989,Annual,2451094,2306850,144244,5.9
Washington,1990,Annual,2525326,2392891,132435,5.2
Washington,1991,Annual,2545980,2384323,161657,6.3
Washington,1992,Annual,2635812,2442480,193332,7.3
Washington,1993,Annual,2692270,2494999,197271,7.3
Washington,1994,Annual,2739472,2559932,179540,6.6
Washington,1995,Annual,2811332,2630220,181112,6.4
Washington,1996,Annual,2884868,2710214,174654,6.1
Washington,1997,Annual,2981747,2835517,146230,4.9
Washington,1998,Annual,3050487,2904286,146201,4.8
Washington,1999,Annual,3085544,2935202,150342,4.9
Washington,2000,Annual,3059339,2901492,157847,5.2
Washington,2001,Annual,3039367,2847875,191492,6.3
Washington,2002,Annual,3082839,2854762,228077,7.4
Washington,2003,Annual,3127404,2895863,231541,7.4
Washington,2004,Annual,3197095,2996795,200300,6.3
Washington,2005,Annual,3263703,3082399,181304,5.6
Washington,2006,Annual,3323938,3156626,167312,5.0
Washington,2007,Annual,3403163,3243308,159855,4.7
Washington,2008,Annual,3478577,3291309,187268,5.4
Washington,2009,Annual,3535200,3211649,323551,9.2
Washington,2010,Annual,3511326,3160544,350782,10.0
Washington,2011,Annual,3461428,3140190,321238,9.3
Washington,2012,Annual,3471282,3189271,282011,8.1
Washington,2013,Annual,3463869,3219842,244027,7.0
Washington,2014,Annual,3489666,3275753,213913,6.1
Washington,2015,Annual,3545904,3345496,200408,5.7
Washington,2016,Annual,3635200,3444126,191074,5.3
Washington,2017,Annual,3724722,3547430,177292,4.8
West Virginia,1976,Annual,697869,646711,51158,7.3
West Virginia,1977,Annual,711266,662302,48964,6.9
West Virginia,1978,Annual,738077,692499,45578,6.2
West Virginia,1979,Annual,770530,717083,53447,6.9
West Virginia,1980,Annual,786225,711819,74406,9.5
West Virginia,1981,Annual,786286,703240,83046,10.6
West Virginia,1982,Annual,782433,673193,109240,14.0
West Virginia,1983,Annual,765479,629121,136358,17.8
West Virginia,1984,Annual,764756,651636,113120,14.8
West Virginia,1985,Annual,757346,657796,99550,13.1
West Virginia,1986,Annual,747599,659400,88199,11.8
West Virginia,1987,Annual,747272,666346,80926,10.8
West Virginia,1988,Annual,748053,674533,73520,9.8
West Virginia,1989,Annual,756974,691729,65245,8.6
West Virginia,1990,Annual,762165,697633,64532,8.5
West Virginia,1991,Annual,776738,694101,82637,10.6
West Virginia,1992,Annual,778882,690770,88112,11.3
West Virginia,1993,Annual,779810,697021,82789,10.6
West Virginia,1994,Annual,782507,713372,69135,8.8
West Virginia,1995,Annual,784567,722870,61697,7.9
West Virginia,1996,Annual,795409,735701,59708,7.5
West Virginia,1997,Annual,796507,741865,54642,6.9
West Virginia,1998,Annual,795145,742528,52617,6.6
West Virginia,1999,Annual,804343,752379,51964,6.5
West Virginia,2000,Annual,809063,764711,44352,5.5
West Virginia,2001,Annual,809128,768661,40467,5.0
West Virginia,2002,Annual,799998,752548,47450,5.9
West Virginia,2003,Annual,786552,738990,47562,6.0
West Virginia,2004,Annual,783658,741890,41768,5.3
West Virginia,2005,Annual,790982,750561,40421,5.1
West Virginia,2006,Annual,806168,766399,39769,4.9
West Virginia,2007,Annual,811160,773990,37170,4.6
West Virginia,2008,Annual,812905,777560,35345,4.3
West Virginia,2009,Annual,814027,751165,62862,7.7
West Virginia,2010,Annual,811125,740910,70215,8.7
West Virginia,2011,Annual,807021,741972,65049,8.1
West Virginia,2012,Annual,807917,747384,60533,7.5
West Virginia,2013,Annual,798530,744410,54120,6.8
West Virginia,2014,Annual,787845,735511,52334,6.6
West Virginia,2015,Annual,780428,727758,52670,6.7
West Virginia,2016,Annual,781600,733980,47620,6.1
West Virginia,2017,Annual,778821,738309,40512,5.2
Wisconsin,1976,Annual,2142236,2023371,118865,5.5
Wisconsin,1977,Annual,2187868,2076223,111645,5.1
Wisconsin,1978,Annual,2261573,2148618,112955,5.0
Wisconsin,1979,Annual,2325984,2219909,106075,4.6
Wisconsin,1980,Annual,2356163,2186318,169845,7.2
Wisconsin,1981,Annual,2378803,2188204,190599,8.0
Wisconsin,1982,Annual,2421495,2166871,254624,10.5
Wisconsin,1983,Annual,2415317,2167806,247511,10.2
Wisconsin,1984,Annual,2392021,2215813,176208,7.4
Wisconsin,1985,Annual,2379204,2208079,171125,7.2
Wisconsin,1986,Annual,2417601,2249171,168430,7.0
Wisconsin,1987,Annual,2486571,2339680,146891,5.9
Wisconsin,1988,Annual,2555148,2442726,112422,4.4
Wisconsin,1989,Annual,2595987,2483256,112731,4.3
Wisconsin,1990,Annual,2589873,2476626,113247,4.4
Wisconsin,1991,Annual,2620564,2476926,143638,5.5
Wisconsin,1992,Annual,2687155,2549773,137382,5.1
Wisconsin,1993,Annual,2754297,2623303,130994,4.8
Wisconsin,1994,Annual,2829522,2701755,127767,4.5
Wisconsin,1995,Annual,2882201,2773322,108879,3.8
Wisconsin,1996,Annual,2933003,2827094,105909,3.6
Wisconsin,1997,Annual,2970086,2864372,105714,3.6
Wisconsin,1998,Annual,2969590,2870031,99559,3.4
Wisconsin,1999,Annual,2947247,2855212,92035,3.1
Wisconsin,2000,Annual,2973221,2868382,104839,3.5
Wisconsin,2001,Annual,3011703,2875585,136118,4.5
Wisconsin,2002,Annual,3024319,2861621,162698,5.4
Wisconsin,2003,Annual,3053642,2879779,173863,5.7
Wisconsin,2004,Annual,3034581,2882064,152517,5.0
Wisconsin,2005,Annual,3021086,2878086,143000,4.7
Wisconsin,2006,Annual,3058935,2914150,144785,4.7
Wisconsin,2007,Annual,3087828,2936452,151376,4.9
Wisconsin,2008,Annual,3091796,2940438,151358,4.9
Wisconsin,2009,Annual,3100348,2834335,266013,8.6
Wisconsin,2010,Annual,3081512,2814393,267119,8.7
Wisconsin,2011,Annual,3079759,2840996,238763,7.8
Wisconsin,2012,Annual,3073981,2857418,216563,7.0
Wisconsin,2013,Annual,3079305,2871997,207308,6.7
Wisconsin,2014,Annual,3082564,2915848,166716,5.4
Wisconsin,2015,Annual,3094351,2953622,140729,4.5
Wisconsin,2016,Annual,3130520,3005478,125042,4.0
Wisconsin,2017,Annual,3151909,3048242,103667,3.3
Wyoming,1976,Annual,179878,172740,7138,4.0
Wyoming,1977,Annual,194801,188203,6598,3.4
Wyoming,1978,Annual,209688,203404,6284,3.0
Wyoming,1979,Annual,223061,216970,6091,2.7
Wyoming,1980,Annual,235940,226853,9087,3.9
Wyoming,1981,Annual,249994,239862,10132,4.1
Wyoming,1982,Annual,257381,241411,15970,6.2
Wyoming,1983,Annual,259713,238539,21174,8.2
Wyoming,1984,Annual,254140,238247,15893,6.3
Wyoming,1985,Annual,251849,234585,17264,6.9
Wyoming,1986,Annual,250778,228478,22300,8.9
Wyoming,1987,Annual,240530,221169,19361,8.0
Wyoming,1988,Annual,237937,222576,15361,6.5
Wyoming,1989,Annual,237771,223160,14611,6.1
Wyoming,1990,Annual,235964,223437,12527,5.3
Wyoming,1991,Annual,235670,223326,12344,5.2
Wyoming,1992,Annual,238859,225504,13355,5.6
Wyoming,1993,Annual,242868,229895,12973,5.3
Wyoming,1994,Annual,250668,238226,12442,5.0
Wyoming,1995,Annual,255335,243076,12259,4.8
Wyoming,1996,Annual,255836,243205,12631,4.9
Wyoming,1997,Annual,253828,241684,12144,4.8
Wyoming,1998,Annual,257589,245490,12099,4.7
Wyoming,1999,Annual,262758,250605,12153,4.6
Wyoming,2000,Annual,266808,256414,10394,3.9
Wyoming,2001,Annual,269359,259089,10270,3.8
Wyoming,2002,Annual,269546,258650,10896,4.0
Wyoming,2003,Annual,273620,261970,11650,4.3
Wyoming,2004,Annual,274794,264321,10473,3.8
Wyoming,2005,Annual,276527,266630,9897,3.6
Wyoming,2006,Annual,281247,272336,8911,3.2
Wyoming,2007,Annual,286560,278486,8074,2.8
Wyoming,2008,Annual,293279,284310,8969,3.1
Wyoming,2009,Annual,300120,281150,18970,6.3
Wyoming,2010,Annual,303297,283744,19553,6.4
Wyoming,2011,Annual,306815,289019,17796,5.8
Wyoming,2012,Annual,307267,290932,16335,5.3
Wyoming,2013,Annual,306608,292131,14477,4.7
Wyoming,2014,Annual,306331,293657,12674,4.1
Wyoming,2015,Annual,304775,291686,13089,4.3
Wyoming,2016,Annual,300922,285052,15870,5.3
Wyoming,2017,Annual,293347,281017,12330,4.2
Puerto Rico,1976,Annual,858567,690600,167967,19.6
Puerto Rico,1977,Annual,874025,699808,174217,19.9
Puerto Rico,1978,Annual,890758,729833,160925,18.1
Puerto Rico,1979,Annual,897425,744608,152817,17.0
Puerto Rico,1980,Annual,916266,759808,156458,17.1
Puerto Rico,1981,Annual,926291,742408,183883,19.9
Puerto Rico,1982,Annual,918100,708525,209575,22.8
Puerto Rico,1983,Annual,953292,730567,222725,23.4
Puerto Rico,1984,Annual,975192,773398,201794,20.7
Puerto Rico,1985,Annual,992272,776364,215908,21.8
Puerto Rico,1986,Annual,1028656,834368,194288,18.9
Puerto Rico,1987,Annual,1057651,880091,177560,16.8
Puerto Rico,1988,Annual,1103349,938302,165047,15.0
Puerto Rico,1989,Annual,1115021,951898,163123,14.6
Puerto Rico,1990,Annual,1132334,971815,160519,14.2
Puerto Rico,1991,Annual,1168623,981845,186778,16.0
Puerto Rico,1992,Annual,1190206,991960,198246,16.7
Puerto Rico,1993,Annual,1217804,1010431,207373,17.0
Puerto Rico,1994,Annual,1208343,1032283,176060,14.6
Puerto Rico,1995,Annual,1247183,1076473,170710,13.7
Puerto Rico,1996,Annual,1283278,1111538,171740,13.4
Puerto Rico,1997,Annual,1309196,1132658,176538,13.5
Puerto Rico,1998,Annual,1310732,1136060,174672,13.3
Puerto Rico,1999,Annual,1294328,1142466,151862,11.7
Puerto Rico,2000,Annual,1291993,1161033,130960,10.1
Puerto Rico,2001,Annual,1273405,1128704,144701,11.4
Puerto Rico,2002,Annual,1321370,1159455,161915,12.3
Puerto Rico,2003,Annual,1345782,1184589,161193,12.0
Puerto Rico,2004,Annual,1347047,1204535,142512,10.6
Puerto Rico,2005,Annual,1378062,1221818,156244,11.3
Puerto Rico,2006,Annual,1419874,1270693,149181,10.5
Puerto Rico,2007,Annual,1387359,1232266,155093,11.2
Puerto Rico,2008,Annual,1345923,1187398,158525,11.8
Puerto Rico,2009,Annual,1301263,1101862,199401,15.3
Puerto Rico,2010,Annual,1268664,1061047,207617,16.4
Puerto Rico,2011,Annual,1220238,1025558,194680,16.0
Puerto Rico,2012,Annual,1194283,1021387,172896,14.5
Puerto Rico,2013,Annual,1166320,999531,166789,14.3
Puerto Rico,2014,Annual,1133985,976224,157761,13.9
Puerto Rico,2015,Annual,1121746,987153,134593,12.0
Puerto Rico,2016,Annual,1117909,986142,131767,11.8
Puerto Rico,2017,Annual,1102646,983264,119382,10.8
